0 0 0 0 0 0 0 0 0 0 0 0 0 0 0 0 0 0 0 0 0 0 0 0 0 0 0 0 0 0 0 0 0 0 0 0 0 0 0 0 0 0 0 0 0 0 0 0 0 0 0 0 0 0 0 0 0 0 0 0 0 0 0 0
0 0 0 0 0 0 0 0 0 0 0 0 0 0 0 0 0 0 0 0 0 0 0 129 140 160 144 176 144 144 128 160 192 0 160 144 160 158 144 150 135 0 0 0 0 0 0 0 0 0 0 0 0 0 0 0 0 0 0 0 0 0 0 0
0 0 0 0 0 0 0 0 0 0 0 0 0 0 0 0 0 0 180 215 224 176 192 224 216 216 200 216 200 200 192 208 224 184 208 200 208 208 208 224 232 232 240 232 238 182 0 0 0 0 0 0 0 0 0 0 0 0 0 0 0 0 0 0
0 0 0 0 0 0 0 0 0 0 0 0 0 0 163 239 256 240 240 224 224 176 192 256 256 256 256 256 256 256 256 256 256 256 256 256 256 256 256 256 256 256 256 256 256 256 256 256 233 152 0 0 0 0 0 0 0 0 0 0 0 0 0 0
0 0 0 0 0 0 0 0 0 0 0 131 231 256 256 256 256 240 240 224 224 176 192 256 256 256 256 256 256 256 256 256 256 256 256 256 256 256 256 256 256 256 256 256 256 256 256 256 256 256 256 223 0 0 0 0 0 0 0 0 0 0 0 0
0 0 0 0 0 0 0 0 0 152 249 256 256 256 256 256 256 240 240 224 224 176 192 256 256 256 256 256 256 256 256 256 256 256 256 256 256 256 256 256 256 256 256 256 256 256 256 256 256 256 256 256 256 230 136 0 0 0 0 0 0 0 0 0
0 0 0 0 0 0 0 0 245 256 256 256 256 256 256 256 256 240 240 224 224 176 192 256 256 256 256 256 256 256 256 256 256 256 256 256 256 256 256 256 256 256 256 256 256 256 256 256 256 256 256 256 256 240 256 238 0 0 0 0 0 0 0 0
0 0 0 0 0 0 203 256 256 256 256 256 256 256 256 256 256 240 240 224 224 176 192 256 256 256 256 256 256 256 256 256 256 256 256 256 256 256 256 256 256 256 256 256 256 256 256 256 256 256 256 256 256 240 256 256 256 188 0 0 0 0 0 0
0 0 0 0 0 240 256 256 256 256 256 256 256 256 256 256 256 240 240 224 224 176 192 256 256 256 256 256 256 256 256 256 256 256 256 256 256 256 256 256 256 256 256 256 256 256 256 256 256 256 256 256 256 240 256 256 256 256 220 0 0 0 0 0
0 0 0 0 209 256 256 256 256 256 256 256 256 256 256 256 256 240 240 227 226 200 206 256 256 256 256 256 256 256 256 256 256 256 256 256 256 256 256 256 256 256 256 256 256 256 256 256 256 256 256 256 256 240 256 256 256 256 240 180 0 0 0 0
0 0 0 230 241 255 256 256 256 256 256 256 256 256 256 256 256 251 232 225 208 224 208 256 256 256 256 256 256 256 256 256 256 256 256 256 256 256 256 256 256 256 256 256 256 256 256 256 256 256 256 256 256 240 256 256 256 256 246 212 196 0 0 0
0 0 215 256 256 256 256 256 256 256 256 256 256 256 256 256 256 256 224 224 208 224 208 256 256 256 256 256 256 256 256 256 256 256 256 256 256 256 256 256 256 256 256 256 256 256 256 256 256 256 256 256 256 240 256 256 256 255 256 256 256 193 0 0
0 0 256 256 256 256 256 256 256 256 255 256 256 256 256 256 256 256 224 224 208 224 208 256 256 256 256 256 256 256 256 256 256 256 256 256 256 256 256 256 256 256 256 256 256 256 256 256 256 256 256 256 256 239 256 256 256 256 256 256 256 256 0 0
0 218 256 256 256 256 256 256 256 256 240 256 256 256 256 256 256 256 224 224 208 224 208 256 256 256 256 256 256 256 256 256 256 256 256 256 256 256 256 256 256 256 256 256 256 256 256 256 256 256 256 256 256 255 250 255 256 256 256 256 256 256 192 0
0 240 240 240 240 240 240 240 244 256 240 256 256 256 256 256 256 256 224 224 208 224 208 256 256 256 256 256 256 256 256 256 256 256 256 256 256 256 256 256 256 256 256 256 256 256 256 256 256 256 256 256 256 256 240 243 240 240 240 240 240 240 236 0
0 208 208 208 208 208 208 208 225 256 240 256 256 256 256 256 256 256 224 224 208 224 208 256 256 256 256 256 256 256 256 256 256 256 256 256 256 256 256 256 256 256 256 256 256 256 256 256 256 256 256 256 256 256 240 148 0 0 0 0 0 0 0 0
0 192 192 192 192 192 192 192 213 256 240 256 256 256 256 256 256 256 224 224 208 224 208 256 256 256 256 256 256 256 256 256 256 256 256 256 256 256 256 256 256 256 256 256 256 256 256 256 256 256 256 256 256 256 240 159 128 128 128 128 128 128 128 0
0 256 256 256 256 256 256 256 256 256 240 256 256 256 256 256 256 256 224 224 208 224 208 256 256 256 256 256 256 256 256 256 256 256 256 256 256 256 256 256 256 256 256 256 256 256 256 256 256 256 256 256 256 256 240 243 240 240 240 240 240 240 238 0
0 226 256 256 256 256 256 256 255 256 240 256 256 256 256 256 256 256 224 224 208 224 208 256 256 256 256 256 256 256 256 256 256 256 256 256 256 256 256 256 256 256 256 256 256 256 256 256 256 256 256 256 256 256 240 256 256 256 256 256 256 256 199 0
0 0 256 256 256 256 256 256 256 256 240 256 256 256 256 256 256 256 224 224 208 224 208 256 256 256 256 256 256 256 256 256 256 256 256 256 256 256 256 256 256 256 256 256 256 256 256 256 256 256 256 256 256 256 240 256 242 224 224 224 224 224 0 0
0 0 226 256 256 256 256 256 256 256 240 256 256 256 256 256 256 256 224 224 208 224 208 256 256 256 256 256 256 256 256 256 256 256 256 256 256 256 256 256 256 256 256 256 256 256 256 256 256 256 256 256 256 256 240 256 256 256 241 240 240 200 0 0
0 0 0 197 199 237 256 256 256 256 240 256 256 256 256 256 256 256 224 224 208 224 208 256 256 256 256 256 256 256 256 256 256 256 256 256 256 256 256 256 256 256 256 256 256 256 256 256 256 256 256 256 256 256 240 256 256 256 235 173 169 0 0 0
0 0 0 0 170 240 256 256 256 256 240 256 256 256 256 256 256 256 224 224 208 224 208 256 256 256 256 256 256 256 256 256 256 256 256 256 256 256 256 256 256 256 256 256 256 256 256 256 256 256 256 256 256 256 240 256 256 256 256 184 0 0 0 0
0 0 0 0 0 234 256 256 256 256 240 256 256 256 256 256 256 256 224 224 208 224 208 256 256 256 256 256 256 256 256 256 256 256 256 256 256 256 256 256 256 256 256 256 256 256 256 256 256 256 256 256 256 256 240 256 256 256 238 0 0 0 0 0
0 0 0 0 0 0 219 256 256 256 240 256 256 256 256 256 256 256 224 224 208 224 208 256 256 256 256 256 256 256 256 256 256 256 256 256 256 256 256 256 256 256 256 256 256 256 256 256 256 256 256 256 256 256 240 256 256 206 0 0 0 0 0 0
0 0 0 0 0 0 0 140 251 256 240 256 256 256 256 256 256 256 224 224 208 224 208 256 256 256 256 256 256 256 256 256 256 256 256 256 256 256 256 256 256 256 256 256 256 256 256 256 256 256 256 256 256 256 240 246 0 0 0 0 0 0 0 0
0 0 0 0 0 0 0 0 0 168 238 256 256 256 256 256 256 256 224 224 208 224 208 256 256 256 256 256 256 256 256 256 256 256 256 256 256 256 256 256 256 256 256 256 256 256 256 256 256 256 256 256 256 250 152 0 0 0 0 0 0 0 0 0
0 0 0 0 0 0 0 0 0 0 0 151 243 256 256 256 256 256 224 224 208 224 208 256 256 256 256 256 256 256 256 256 256 256 256 256 256 256 256 256 256 256 256 256 256 256 256 256 256 256 256 237 141 0 0 0 0 0 0 0 0 0 0 0
0 0 0 0 0 0 0 0 0 0 0 0 0 0 184 249 256 256 224 224 208 224 208 256 256 256 256 256 256 256 256 256 256 256 256 256 256 256 256 256 256 256 256 256 256 256 256 256 246 173 0 0 0 0 0 0 0 0 0 0 0 0 0 0
0 0 0 0 0 0 0 0 0 0 0 0 0 0 0 0 0 150 187 223 208 224 208 228 228 228 207 207 207 193 207 144 144 207 186 221 207 221 214 228 228 228 228 242 239 202 143 0 0 0 0 0 0 0 0 0 0 0 0 0 0 0 0 0
0 0 0 0 0 0 0 0 0 0 0 0 0 0 0 0 0 0 0 0 0 0 0 143 167 188 144 144 144 0 144 0 0 144 0 176 144 176 156 166 141 0 0 0 0 0 0 0 0 0 0 0 0 0 0 0 0 0 0 0 0 0 0 0
0 0 0 0 0 0 0 0 0 0 0 0 0 0 0 0 0 0 0 0 0 0 0 0 0 0 0 0 0 0 0 0 0 0 0 0 0 0 0 0 0 0 0 0 0 0 0 0 0 0 0 0 0 0 0 0 0 0 0 0 0 0 0 0