256 256 256 256 256 256 256 256 256 256 256 256 256 256 256 256 256 256 256 256 256 256 256 256 256 256 256 256 256 256 256 256 256 256 256 256 256 256 256 256 256 256 256 256 256 256 256 256 256 256 256 256 256 256 256 256 256 256 256 256 256 256 256 256
256 256 256 256 256 256 256 256 256 256 256 256 256 256 256 256 256 256 256 256 256 256 256 256 256 256 256 256 256 256 256 256 256 256 256 256 256 256 256 256 256 256 256 256 256 256 256 256 256 256 256 256 256 256 256 256 256 256 256 256 256 256 256 256
256 256 256 256 256 256 256 256 256 256 256 256 256 256 256 256 256 256 256 256 256 256 256 256 184 160 160 160 160 160 160 160 160 160 160 160 160 160 160 189 256 256 256 256 256 256 256 256 256 256 256 256 256 256 256 256 256 256 256 256 256 256 256 256
256 256 256 256 256 256 256 256 256 256 256 256 256 256 256 256 256 256 256 256 256 256 256 256 64 0 0 0 0 0 0 0 0 0 0 0 0 0 0 79 256 256 256 256 256 256 256 256 256 256 256 256 256 256 256 256 256 256 256 256 256 256 256 256
256 256 256 256 256 256 256 256 256 256 256 256 256 256 256 256 256 256 256 256 256 256 256 256 256 256 256 256 256 256 256 256 256 256 256 256 256 256 256 256 256 256 256 256 256 256 256 256 256 256 256 256 256 256 256 256 256 256 256 256 256 256 256 256
256 256 256 256 256 256 256 256 256 256 256 256 256 256 256 256 256 256 256 256 256 256 256 256 256 256 256 256 256 256 256 256 256 256 256 256 256 256 256 256 256 256 256 256 256 256 256 256 256 256 256 256 256 256 256 256 256 256 256 256 256 256 256 256
256 256 256 256 256 256 256 256 256 256 256 243 186 147 128 160 200 253 256 256 256 256 256 256 256 256 256 256 256 256 256 256 256 256 256 256 256 256 256 256 256 256 256 256 256 256 254 200 161 128 147 186 243 256 256 256 256 256 256 256 256 256 256 256
256 256 256 256 256 256 256 256 256 242 111 0 0 0 0 0 0 0 150 255 256 256 256 256 256 256 256 256 256 256 256 256 256 256 256 256 256 256 256 256 256 256 256 256 254 150 0 0 0 0 0 0 0 113 242 256 256 256 256 256 256 256 256 256
256 256 256 256 256 256 256 256 213 0 0 0 0 0 0 0 0 0 0 71 241 256 256 256 256 256 256 256 256 256 256 256 256 256 256 256 256 256 256 256 256 256 256 241 70 0 0 0 0 0 0 0 0 0 0 211 256 256 256 256 256 256 256 256
256 256 256 256 256 256 256 222 0 0 0 94 195 255 256 247 172 55 0 0 63 251 256 256 256 256 256 256 256 256 256 256 256 256 256 256 256 256 256 256 256 256 250 62 0 0 56 172 246 256 255 195 95 0 0 0 223 256 256 256 256 256 256 256
256 256 256 256 256 256 254 54 0 0 181 256 256 256 256 256 256 254 120 0 0 126 256 256 256 256 256 256 256 256 256 256 256 256 256 256 256 256 256 256 256 256 127 0 0 122 254 256 256 256 256 256 256 180 0 0 58 254 256 256 256 256 256 256
256 256 256 256 256 256 170 0 0 175 256 256 256 256 256 256 256 256 256 106 0 0 235 256 256 256 256 256 256 256 256 256 256 256 256 256 256 256 256 256 256 238 0 0 105 256 256 256 256 256 256 256 256 256 173 0 0 171 256 256 256 256 256 256
256 256 256 256 256 256 76 0 82 256 256 256 256 256 256 256 256 256 256 241 0 0 147 256 256 256 256 256 256 256 256 256 256 256 256 256 256 256 256 256 256 149 0 0 243 256 256 256 256 256 256 256 256 256 256 81 0 80 256 256 256 256 256 256
256 256 256 256 256 256 0 0 186 256 256 256 256 256 256 256 256 256 256 256 213 192 217 256 256 256 256 256 256 256 256 256 256 256 256 256 256 256 256 256 256 217 192 212 256 256 256 256 256 256 256 256 256 256 256 176 0 0 256 256 256 256 256 256
256 256 256 256 256 250 0 0 232 256 256 256 256 97 0 160 256 256 256 256 256 256 256 256 256 256 256 256 256 256 256 256 256 256 256 256 256 256 256 256 256 256 256 256 256 256 256 256 159 0 99 256 256 256 256 233 0 0 247 256 256 256 256 256
256 256 256 256 256 251 0 0 239 256 256 256 249 0 0 78 256 256 256 256 256 256 256 256 256 256 256 256 256 256 256 256 256 256 256 256 256 256 256 256 256 256 256 256 256 256 256 256 66 0 0 247 256 256 256 240 0 0 247 256 256 256 256 256
256 256 256 256 256 256 0 0 212 256 256 256 256 135 54 186 256 256 256 256 238 224 237 256 256 256 256 256 256 256 256 256 256 256 256 256 256 256 256 256 256 237 224 238 256 256 256 256 184 54 135 256 256 256 256 210 0 0 256 256 256 256 256 256
256 256 256 256 256 256 75 0 135 256 256 256 256 256 256 256 256 256 256 256 64 0 146 256 256 256 256 256 256 256 256 256 256 256 256 256 256 256 256 256 256 145 0 63 256 256 256 256 256 256 256 256 256 256 256 133 0 75 256 256 256 256 256 256
256 256 256 256 256 256 169 0 0 236 256 256 256 256 256 256 256 256 256 188 0 0 232 256 256 256 256 256 256 256 256 256 256 256 256 256 256 256 256 256 256 234 0 0 188 256 256 256 256 256 256 256 256 256 238 0 0 169 256 256 256 256 256 256
256 256 256 256 256 256 252 0 0 70 249 256 256 256 256 256 256 256 222 0 0 121 256 256 256 256 256 256 256 256 256 256 256 256 256 256 256 256 256 256 256 256 122 0 0 223 256 256 256 256 256 256 256 248 70 0 52 254 256 256 256 256 256 256
256 256 256 256 256 256 256 218 0 0 58 215 256 256 256 256 256 177 0 0 62 250 256 256 256 256 256 256 256 256 256 256 256 256 256 256 256 256 256 256 256 256 252 62 0 0 179 256 256 256 256 256 215 58 0 0 221 256 256 256 256 256 256 256
256 256 256 256 256 248 128 128 88 0 0 0 62 122 128 111 0 0 0 0 199 256 256 256 256 256 256 256 256 256 256 256 256 256 256 256 256 256 256 256 256 160 128 116 0 0 0 0 111 128 122 62 0 0 0 148 254 256 256 256 256 256 256 256
256 256 256 256 256 240 0 0 0 0 0 0 0 0 0 0 0 0 0 0 0 129 256 256 256 256 256 256 256 256 256 256 256 256 256 256 256 256 256 256 256 64 0 0 0 0 0 0 0 0 0 0 0 0 0 0 71 246 256 256 256 256 256 256
256 256 256 256 256 247 128 128 128 128 128 128 128 128 128 128 128 128 128 109 0 0 186 256 256 256 256 256 256 256 256 256 256 256 256 256 256 256 256 256 256 160 128 128 128 128 128 128 128 128 128 128 128 128 123 0 0 113 256 256 256 256 256 256
256 256 256 256 256 256 256 256 256 256 256 256 256 256 256 256 256 256 256 256 145 0 80 256 256 256 256 256 256 256 256 256 256 256 256 256 256 256 256 256 256 256 256 256 256 256 256 256 256 256 256 256 256 256 256 213 0 0 252 256 256 256 256 256
256 256 256 256 256 256 256 256 256 256 256 256 256 256 256 256 256 256 256 256 233 0 0 256 256 256 256 256 256 256 256 256 256 256 256 256 256 256 256 256 256 256 256 256 256 256 256 256 256 256 256 256 256 256 256 256 0 0 229 256 256 256 256 256
256 256 256 256 256 256 256 256 256 256 256 256 256 256 256 256 256 256 256 256 208 0 56 256 256 256 256 256 256 256 256 256 256 256 256 256 256 256 256 256 256 256 256 256 256 256 256 256 256 256 256 256 256 256 256 253 0 0 241 256 256 256 256 256
256 256 256 256 256 256 256 256 256 256 256 256 256 256 256 256 256 256 256 237 61 0 124 256 256 256 256 256 256 256 256 256 256 256 256 256 256 256 256 256 256 256 256 256 256 256 256 256 256 256 256 256 256 256 251 116 0 54 256 256 256 256 256 256
256 256 256 256 256 256 256 256 256 256 256 256 256 256 256 256 256 256 256 73 0 0 241 256 256 256 256 256 256 256 256 256 256 256 256 256 256 256 256 256 256 256 256 256 256 256 256 256 256 256 256 256 256 256 158 0 0 201 256 256 256 256 256 256
256 256 256 256 256 256 256 256 256 256 256 256 256 256 256 256 256 256 256 119 90 233 256 256 256 256 256 256 256 256 256 256 256 256 256 256 256 256 256 256 256 256 256 256 256 256 256 256 256 256 256 256 256 256 185 65 200 256 256 256 256 256 256 256
256 256 256 256 256 256 256 256 256 256 256 256 256 256 256 256 256 256 256 256 256 256 256 256 256 256 256 256 256 256 256 256 256 256 256 256 256 256 256 256 256 256 256 256 256 256 256 256 256 256 256 256 256 256 256 256 256 256 256 256 256 256 256 256
256 256 256 256 256 256 256 256 256 256 256 256 256 256 256 256 256 256 256 256 256 256 256 256 256 256 256 256 256 256 256 256 256 256 256 256 256 256 256 256 256 256 256 256 256 256 256 256 256 256 256 256 256 256 256 256 256 256 256 256 256 256 256 256