0 0 0 0 0 0 0 0 0 0 0 90 121 148 160 176 176 160 147 121 88 0 0 0 0 0 0 0 0 0 0 0
0 0 0 0 0 0 0 114 189 246 256 256 256 256 256 256 256 256 256 256 256 256 246 187 113 0 0 0 0 0 0 0
0 0 0 0 54 178 254 256 256 256 256 256 256 256 256 256 256 256 256 256 256 256 256 256 256 253 174 52 0 0 0 0
0 0 0 158 255 256 256 256 256 256 256 256 256 256 256 256 256 256 256 256 256 256 256 256 256 256 256 255 154 0 0 0
0 0 210 256 256 256 256 256 256 256 256 256 256 256 256 256 256 256 256 256 256 256 256 256 256 256 256 256 256 208 0 0
0 198 256 256 256 256 256 256 256 256 256 256 256 256 256 256 256 256 256 256 256 256 256 256 256 256 256 256 256 256 193 0
101 256 256 256 256 256 256 256 256 256 256 256 256 256 256 256 256 256 256 256 256 256 256 256 256 256 256 256 256 256 256 79
168 256 256 256 256 256 256 256 256 256 256 256 256 256 256 256 256 256 256 256 256 256 256 256 256 256 256 256 256 256 256 147
165 256 256 256 256 256 256 256 256 256 256 256 256 256 256 256 256 256 256 256 256 256 256 256 256 256 256 256 256 256 256 145
92 256 256 256 256 256 256 256 256 256 256 256 256 256 256 256 256 256 256 256 256 256 256 256 256 256 256 256 256 256 256 70
0 186 256 256 256 256 256 256 256 256 256 256 256 256 256 256 256 256 256 256 256 256 256 256 256 256 256 256 256 256 180 0
0 0 198 256 256 256 256 256 256 256 256 256 256 256 256 256 256 256 256 256 256 256 256 256 256 256 256 256 256 196 0 0
0 0 0 138 252 256 256 256 256 256 256 256 256 256 256 256 256 256 256 256 256 256 256 256 256 256 256 251 136 0 0 0
0 0 0 0 0 159 248 256 256 256 256 256 256 256 256 256 256 256 256 256 256 256 256 256 256 246 156 0 0 0 0 0
0 0 0 0 0 0 0 97 171 234 256 256 256 256 256 256 256 256 256 256 256 256 232 169 93 0 0 0 0 0 0 0
0 0 0 0 0 0 0 0 0 0 0 87 120 145 160 171 171 160 144 120 86 0 0 0 0 0 0 0 0 0 0 0