256 256 256 256 256 256 256 256 256 256 256 256 256 256 256 256 256 256 256 256 256 256 256 256 256 256 256 256 256 256 256 256 256 256 256 256 256 256 256 256 256 256 256 256 256 256 256 256 256 256 256 256 256 256 256 256 256 256 256 256 256 256 256 256
256 256 256 256 256 256 256 256 256 256 256 256 256 256 256 256 256 256 256 256 256 256 256 256 256 256 253 224 197 176 151 158 141 151 158 181 187 224 247 256 256 256 256 256 256 256 256 256 256 256 256 256 256 256 256 256 256 256 256 256 256 256 256 256
256 256 256 256 256 256 256 256 256 256 256 256 256 256 256 256 256 256 256 256 256 256 253 201 161 86 0 0 0 60 0 62 0 62 0 98 75 0 97 123 150 194 239 256 256 256 256 256 256 256 256 256 256 256 256 256 256 256 256 256 256 256 256 256
256 256 256 256 256 256 256 256 256 256 256 256 256 256 256 256 256 256 256 256 224 154 95 84 66 0 0 0 0 0 0 0 0 0 0 0 0 0 0 0 0 106 96 134 214 256 256 256 256 256 256 256 256 256 256 256 256 256 256 256 256 256 256 256
256 256 256 256 256 256 256 256 256 256 256 256 256 256 256 256 256 256 226 143 69 0 0 0 0 82 136 162 206 210 248 256 256 256 256 256 256 224 142 110 0 0 0 59 91 142 216 256 256 256 256 256 256 256 256 256 256 256 256 256 256 256 256 256
256 256 256 256 256 256 256 256 256 256 256 256 256 256 256 256 248 151 52 0 0 0 0 155 243 256 256 256 256 256 256 256 256 256 256 256 256 256 256 256 252 183 98 0 0 76 64 144 237 256 256 256 256 256 256 256 256 256 256 256 256 256 256 256
256 256 256 256 256 256 256 256 256 256 256 256 256 256 256 226 122 0 0 0 106 185 253 256 256 256 256 256 256 241 212 192 192 192 191 240 251 256 256 256 256 256 256 244 163 0 0 150 85 215 256 256 256 256 256 256 256 256 256 256 256 256 256 256
256 256 256 256 256 256 256 256 256 256 256 256 256 256 216 0 0 0 65 230 256 256 256 256 256 256 233 113 0 0 0 0 0 0 0 0 70 103 196 256 256 256 256 256 256 236 104 0 0 57 201 256 256 256 256 256 256 256 256 256 256 256 256 256
256 256 256 256 256 256 256 256 256 256 256 256 256 223 123 0 0 115 250 256 256 256 256 256 256 151 0 0 0 0 0 0 0 0 0 0 0 0 0 101 225 256 256 256 256 256 256 193 0 0 105 192 256 256 256 256 256 256 256 256 256 256 256 256
256 256 256 256 256 256 256 256 256 256 256 256 243 122 67 0 142 256 256 256 256 256 256 256 197 0 0 0 71 133 144 144 144 144 144 136 81 0 0 0 0 256 256 256 256 256 256 256 222 0 0 120 210 256 256 256 256 256 256 256 256 256 256 256
256 256 256 256 256 256 256 256 256 256 256 256 169 112 0 159 256 256 256 256 256 256 256 256 247 85 85 224 256 256 256 256 256 256 256 256 256 252 161 66 124 256 256 256 256 256 256 256 256 233 0 71 163 254 256 256 256 256 256 256 256 256 256 256
256 256 256 256 256 256 256 256 256 256 256 256 256 256 256 256 256 256 256 256 256 256 256 256 256 256 256 256 256 256 256 256 256 256 256 256 256 256 256 256 256 256 256 256 256 256 256 256 256 256 253 245 256 256 256 256 256 256 256 256 256 256 256 256
256 256 256 256 256 256 256 256 256 256 256 256 256 256 256 256 256 256 256 256 256 256 256 256 256 256 256 256 256 256 256 256 256 256 256 256 256 256 256 256 256 256 256 256 256 256 256 256 256 256 256 256 256 256 256 256 256 256 256 256 256 256 256 256
256 256 256 256 256 256 256 256 256 256 256 256 256 256 256 256 256 256 256 256 256 256 256 256 256 256 256 256 256 256 256 256 256 256 256 256 256 256 256 256 256 256 256 256 256 256 256 256 256 256 256 256 256 256 256 256 256 256 256 256 256 256 256 256
256 256 256 256 256 256 256 256 256 256 249 170 155 234 256 256 256 256 256 256 256 256 256 256 256 256 256 256 256 256 256 256 256 256 256 256 256 256 256 256 256 256 256 256 256 256 256 256 256 256 256 256 188 165 225 256 256 256 256 256 256 256 256 256
256 256 256 256 256 256 256 256 256 256 195 73 0 176 256 256 256 256 256 256 256 256 256 209 99 80 145 244 256 256 256 256 256 256 256 256 256 256 186 92 81 157 253 256 256 256 256 256 256 256 256 256 0 0 157 256 256 256 256 256 256 256 256 256
256 256 256 256 256 256 256 256 256 256 207 78 0 176 256 256 256 256 256 256 256 256 183 0 0 0 0 0 250 256 256 256 256 256 256 256 256 146 0 0 0 0 82 253 256 256 256 256 256 256 256 255 0 63 149 256 256 256 256 256 256 256 256 256
256 256 256 256 256 256 256 256 256 256 222 83 0 163 256 256 256 256 256 256 256 255 0 0 0 0 0 0 149 256 256 256 256 256 256 256 240 0 0 0 0 0 0 191 256 256 256 256 256 256 256 209 0 100 181 256 256 256 256 256 256 256 256 256
256 256 256 256 256 256 256 256 256 215 107 54 0 124 256 256 256 256 256 256 256 240 0 0 0 0 0 0 105 256 256 256 256 256 256 256 199 0 0 0 0 0 0 128 256 256 256 256 256 256 256 125 0 99 115 170 256 256 256 256 256 256 256 256
256 256 256 256 256 256 256 256 251 90 119 0 83 0 254 256 256 256 256 256 256 249 0 0 0 0 0 0 133 256 256 256 256 256 256 256 231 0 0 0 0 0 0 155 256 256 256 256 256 256 240 0 69 57 61 135 200 256 256 256 256 256 256 256
256 256 256 256 256 256 256 256 157 0 0 151 114 0 150 256 256 256 256 256 256 256 123 0 0 0 0 0 220 256 256 256 256 256 256 256 256 87 0 0 0 0 0 244 256 256 256 256 256 256 126 0 111 185 115 0 127 256 256 256 256 256 256 256
256 256 256 256 256 256 256 256 110 0 95 256 146 70 0 214 256 256 256 256 256 256 252 127 0 0 55 205 256 256 256 256 256 256 256 256 256 245 112 0 0 67 209 256 256 256 256 256 256 222 0 0 102 254 236 0 61 236 256 256 256 256 256 256
256 256 256 256 256 256 256 256 124 71 112 256 238 169 136 201 256 256 256 256 256 256 256 256 255 239 256 256 256 256 256 256 256 256 256 256 256 256 256 253 242 256 256 256 256 256 256 256 256 202 151 162 216 256 255 0 0 224 256 256 256 256 256 256
256 256 256 256 256 256 256 256 128 64 60 256 256 256 256 256 256 256 256 256 256 256 256 256 256 256 256 256 256 256 256 256 256 256 256 256 256 256 256 256 256 256 256 256 256 256 256 256 256 256 256 256 256 256 206 0 77 244 256 256 256 256 256 256
256 256 256 256 256 256 256 256 193 57 0 180 256 256 256 248 247 247 230 247 256 256 256 256 256 256 256 256 256 256 256 256 256 256 256 256 256 256 256 256 256 256 256 256 256 253 240 246 246 243 256 256 256 254 91 0 138 256 256 256 256 256 256 256
256 256 256 256 256 256 256 256 253 116 0 0 103 118 82 0 0 90 71 0 120 229 256 256 256 256 256 256 256 256 256 256 256 256 256 256 256 256 256 256 256 256 256 256 193 0 0 89 107 109 176 176 166 81 0 97 213 256 256 256 256 256 256 256
256 256 256 256 256 256 256 256 256 237 101 67 95 0 69 77 121 166 121 72 0 0 129 166 235 256 256 256 256 256 256 256 256 256 256 256 256 256 256 256 256 225 140 0 0 87 72 147 141 0 66 69 0 69 116 187 256 256 256 256 256 256 256 256
256 256 256 256 256 256 256 256 256 256 256 194 138 71 124 164 242 256 233 143 105 109 74 55 0 56 88 165 203 229 254 256 256 256 256 256 256 227 205 127 0 0 0 68 83 137 210 256 256 200 148 118 140 137 239 256 256 256 256 256 256 256 256 256
256 256 256 256 256 256 256 256 256 256 256 256 256 256 256 256 256 256 256 256 234 173 106 0 0 0 0 0 0 0 0 0 0 0 0 0 0 0 0 0 0 65 81 166 225 256 256 256 256 256 256 256 256 256 256 256 256 256 256 256 256 256 256 256
256 256 256 256 256 256 256 256 256 256 256 256 256 256 256 256 256 256 256 256 256 256 256 209 176 115 117 114 100 0 0 0 0 0 0 0 64 96 61 126 149 194 254 256 256 256 256 256 256 256 256 256 256 256 256 256 256 256 256 256 256 256 256 256
256 256 256 256 256 256 256 256 256 256 256 256 256 256 256 256 256 256 256 256 256 256 256 256 256 256 252 240 205 195 164 128 82 83 156 191 198 231 248 256 256 256 256 256 256 256 256 256 256 256 256 256 256 256 256 256 256 256 256 256 256 256 256 256
256 256 256 256 256 256 256 256 256 256 256 256 256 256 256 256 256 256 256 256 256 256 256 256 256 256 256 256 256 256 256 256 256 256 256 256 256 256 256 256 256 256 256 256 256 256 256 256 256 256 256 256 256 256 256 256 256 256 256 256 256 256 256 256