64 64 64 64 64 64 64 64 64 64 64 64 64 64 64 64 64 64 64 64 64 64 64 64 64 64 64 64 64 64 64 64 64 64 64 64 64 64 64 64 64 64 64 64 64 64 64 64 64 64 64 64 64 64 64 64 64 64 64 64 64 64 64 64
64 64 64 64 64 64 64 64 64 64 64 64 64 64 64 64 64 64 64 64 64 64 64 64 64 64 63 56 47 40 35 35 31 34 36 41 43 56 61 64 64 64 64 64 64 64 64 64 64 64 64 64 64 64 64 64 64 64 64 64 64 64 64 64
64 64 64 64 64 64 64 64 64 64 64 64 64 64 64 64 64 64 64 64 64 64 63 51 40 18 13 0 0 15 0 15 0 14 0 24 20 0 24 28 34 49 59 64 64 64 64 64 64 64 64 64 64 64 64 64 64 64 64 64 64 64 64 64
64 64 64 64 64 64 64 64 64 64 64 64 64 64 64 64 64 64 64 64 57 38 22 18 16 0 0 0 0 0 0 0 0 0 0 0 0 0 0 0 0 24 25 34 53 64 64 64 64 64 64 64 64 64 64 64 64 64 64 64 64 64 64 64
64 64 64 64 64 64 64 64 64 64 64 64 64 64 64 64 64 64 56 36 19 0 0 0 0 21 36 41 55 56 64 64 64 64 64 64 64 58 37 29 0 0 0 13 20 30 53 64 64 64 64 64 64 64 64 64 64 64 64 64 64 64 64 64
64 64 64 64 64 64 64 64 64 64 64 64 64 64 64 64 62 37 0 0 0 0 0 39 61 64 64 64 64 64 64 64 64 64 64 64 64 64 64 64 64 48 28 0 0 19 18 34 57 64 64 64 64 64 64 64 64 64 64 64 64 64 64 64
64 64 64 64 64 64 64 64 64 64 64 64 64 64 64 57 29 0 0 0 28 48 64 64 64 64 64 64 64 57 51 48 48 48 48 56 61 64 64 64 64 64 64 63 44 0 0 34 20 51 64 64 64 64 64 64 64 64 64 64 64 64 64 64
64 64 64 64 64 64 64 64 64 64 64 64 64 64 54 0 0 0 17 57 64 64 64 64 64 64 57 28 0 0 0 0 0 0 0 0 15 24 48 64 64 64 64 64 64 60 29 0 0 15 51 64 64 64 64 64 64 64 64 64 64 64 64 64
64 64 64 64 64 64 64 64 64 64 64 64 64 56 32 0 0 30 63 64 64 64 64 64 64 38 0 0 0 0 0 0 0 0 0 0 0 0 0 23 53 64 64 64 64 64 64 52 0 0 26 47 64 64 64 64 64 64 64 64 64 64 64 64
64 64 64 64 64 64 64 64 64 64 64 64 60 31 15 0 36 64 64 64 64 64 64 64 49 0 0 0 19 35 40 40 40 40 40 38 22 0 0 0 13 64 64 64 64 64 64 64 57 14 0 30 50 64 64 64 64 64 64 64 64 64 64 64
64 64 64 64 64 64 64 64 64 64 64 64 45 33 0 39 64 64 64 64 64 64 64 64 63 25 23 57 64 64 64 64 64 64 64 64 64 64 43 18 30 64 64 64 64 64 64 64 64 60 0 20 40 64 64 64 64 64 64 64 64 64 64 64
64 64 64 64 64 64 64 64 64 64 64 64 64 64 64 64 64 64 64 64 64 64 64 64 64 64 64 64 64 64 64 64 64 64 64 64 64 64 64 64 64 64 64 64 64 64 64 64 64 64 64 62 64 64 64 64 64 64 64 64 64 64 64 64
64 64 64 64 64 64 64 64 64 64 64 64 64 64 64 64 64 64 64 64 64 64 64 64 64 64 64 64 64 64 64 64 64 64 64 64 64 64 64 64 64 64 64 64 64 64 64 64 64 64 64 64 64 64 64 64 64 64 64 64 64 64 64 64
64 64 64 64 64 64 64 64 64 64 64 64 64 64 64 64 64 64 64 64 64 64 64 64 64 64 64 64 64 64 64 64 64 64 64 64 64 64 64 64 64 64 64 64 64 64 64 64 64 64 64 64 64 64 64 64 64 64 64 64 64 64 64 64
64 64 64 64 64 64 64 64 64 64 64 38 37 57 64 64 64 64 64 64 64 64 64 64 64 64 64 64 64 64 64 64 64 64 64 64 64 64 64 64 64 64 64 64 64 64 64 64 64 64 64 64 45 39 54 64 64 64 64 64 64 64 64 64
64 64 64 64 64 64 64 64 64 64 52 16 0 40 64 64 64 64 64 64 64 64 64 52 23 16 35 59 64 64 64 64 64 64 64 64 64 64 45 20 16 38 62 64 64 64 64 64 64 64 64 64 0 0 40 64 64 64 64 64 64 64 64 64
64 64 64 64 64 64 64 64 64 64 55 22 0 40 64 64 64 64 64 64 64 64 45 0 0 0 0 0 61 64 64 64 64 64 64 64 64 37 0 0 0 0 18 62 64 64 64 64 64 64 64 64 0 16 38 64 64 64 64 64 64 64 64 64
64 64 64 64 64 64 64 64 64 64 57 21 0 40 64 64 64 64 64 64 64 64 0 0 0 0 0 0 34 64 64 64 64 64 64 64 60 0 0 0 0 0 0 46 64 64 64 64 64 64 64 53 0 24 42 64 64 64 64 64 64 64 64 64
64 64 64 64 64 64 64 64 64 55 30 13 0 28 64 64 64 64 64 64 64 64 0 0 0 0 0 0 24 64 64 64 64 64 64 64 52 0 0 0 0 0 0 32 64 64 64 64 64 64 64 32 0 25 31 40 64 64 64 64 64 64 64 64
64 64 64 64 64 64 64 64 64 20 31 0 20 0 63 64 64 64 64 64 64 64 0 0 0 0 0 0 33 64 64 64 64 64 64 64 58 0 0 0 0 0 0 38 64 64 64 64 64 64 60 0 19 17 14 35 50 64 64 64 64 64 64 64
64 64 64 64 64 64 64 64 40 0 0 41 29 13 34 64 64 64 64 64 64 64 35 0 0 0 0 0 54 64 64 64 64 64 64 64 64 24 0 0 0 0 0 59 64 64 64 64 64 64 33 0 25 44 33 0 30 64 64 64 64 64 64 64
64 64 64 64 64 64 64 64 27 0 21 64 38 20 0 52 64 64 64 64 64 64 64 34 0 0 16 51 64 64 64 64 64 64 64 64 64 63 32 0 0 19 52 64 64 64 64 64 64 56 0 0 25 64 61 0 17 59 64 64 64 64 64 64
64 64 64 64 64 64 64 64 33 13 24 64 60 43 34 50 64 64 64 64 64 64 64 64 64 60 64 64 64 64 64 64 64 64 64 64 64 64 64 64 60 64 64 64 64 64 64 64 64 52 38 42 53 64 64 0 0 56 64 64 64 64 64 64
64 64 64 64 64 64 64 64 30 18 0 64 64 64 64 64 64 64 64 64 64 64 64 64 64 64 64 64 64 64 64 64 64 64 64 64 64 64 64 64 64 64 64 64 64 64 64 64 64 64 64 64 64 64 53 0 17 61 64 64 64 64 64 64
64 64 64 64 64 64 64 64 50 15 0 42 64 64 64 60 59 60 56 60 64 64 64 64 64 64 64 64 64 64 64 64 64 64 64 64 64 64 64 64 64 64 64 64 64 63 56 58 59 57 64 64 64 64 23 0 33 64 64 64 64 64 64 64
64 64 64 64 64 64 64 64 64 31 0 0 23 26 17 0 0 24 17 0 27 55 64 64 64 64 64 64 64 64 64 64 64 64 64 64 64 64 64 64 64 64 64 64 48 0 0 25 28 24 40 40 39 19 0 22 54 64 64 64 64 64 64 64
64 64 64 64 64 64 64 64 64 62 27 16 24 0 16 20 32 43 28 19 0 0 29 41 57 64 64 64 64 64 64 64 64 64 64 64 64 64 64 64 64 55 32 0 0 23 16 37 37 15 15 19 0 18 28 48 64 64 64 64 64 64 64 64
64 64 64 64 64 64 64 64 64 64 64 53 35 17 30 42 61 64 60 36 26 26 19 16 0 0 19 39 48 56 63 64 64 64 64 64 64 55 49 30 0 0 0 19 22 32 54 64 64 53 38 27 35 37 61 64 64 64 64 64 64 64 64 64
64 64 64 64 64 64 64 64 64 64 64 64 64 64 64 64 64 64 64 64 61 45 25 13 15 0 0 0 0 0 0 0 0 0 0 0 0 0 0 0 0 18 19 41 59 64 64 64 64 64 64 64 64 64 64 64 64 64 64 64 64 64 64 64
64 64 64 64 64 64 64 64 64 64 64 64 64 64 64 64 64 64 64 64 64 64 64 55 42 27 31 30 29 0 0 0 0 0 0 0 17 25 16 34 35 50 63 64 64 64 64 64 64 64 64 64 64 64 64 64 64 64 64 64 64 64 64 64
64 64 64 64 64 64 64 64 64 64 64 64 64 64 64 64 64 64 64 64 64 64 64 64 64 64 64 64 50 48 41 32 20 20 38 47 48 60 64 64 64 64 64 64 64 64 64 64 64 64 64 64 64 64 64 64 64 64 64 64 64 64 64 64
64 64 64 64 64 64 64 64 64 64 64 64 64 64 64 64 64 64 64 64 64 64 64 64 64 64 64 64 64 64 64 64 64 64 64 64 64 64 64 64 64 64 64 64 64 64 64 64 64 64 64 64 64 64 64 64 64 64 64 64 64 64 64 64