64 64 64 64 64 64 64 64 64 64 64 64 64 64 64 64 64 64 64 64 64 64 64 64 64 64 64 64 64 64 64 64 64 64 64 64 64 64 64 64 64 64 64 64 64 64 64 64 64 64 64 64 64 64 64 64 64 64 64 64 64 64 64 64
64 64 64 64 64 64 64 64 64 64 64 64 64 64 64 64 64 64 64 64 64 64 64 64 64 64 64 64 64 64 64 64 64 64 64 64 64 64 64 64 64 64 64 64 64 64 64 64 64 64 64 64 64 64 64 64 64 64 64 64 64 64 64 64
64 64 64 64 64 64 64 64 64 64 64 64 64 64 64 64 64 64 64 64 64 64 64 64 46 40 40 40 40 40 40 40 40 40 40 40 40 40 40 46 64 64 64 64 64 64 64 64 64 64 64 64 64 64 64 64 64 64 64 64 64 64 64 64
64 64 64 64 64 64 64 64 64 64 64 64 64 64 64 64 64 64 64 64 64 64 64 64 16 0 0 0 0 0 0 0 0 0 0 0 0 0 0 16 64 64 64 64 64 64 64 64 64 64 64 64 64 64 64 64 64 64 64 64 64 64 64 64
64 64 64 64 64 64 64 64 64 64 64 64 64 64 64 64 64 64 64 64 64 64 64 64 64 64 64 64 64 64 64 64 64 64 64 64 64 64 64 64 64 64 64 64 64 64 64 64 64 64 64 64 64 64 64 64 64 64 64 64 64 64 64 64
64 64 64 64 64 64 64 64 64 64 64 64 64 64 64 64 64 64 64 64 64 64 64 64 64 64 64 64 64 64 64 64 64 64 64 64 64 64 64 64 64 64 64 64 64 64 64 64 64 64 64 64 64 64 64 64 64 64 64 64 64 64 64 64
64 64 64 64 64 64 64 64 64 64 64 61 44 36 32 38 47 63 64 64 64 64 64 64 64 64 64 64 64 64 64 64 64 64 64 64 64 64 64 64 64 64 64 64 64 64 63 49 39 32 36 44 59 64 64 64 64 64 64 64 64 64 64 64
64 64 64 64 64 64 64 64 64 60 27 0 0 0 0 0 0 0 35 63 64 64 64 64 64 64 64 64 64 64 64 64 64 64 64 64 64 64 64 64 64 64 64 64 63 37 0 0 0 0 0 0 0 25 60 64 64 64 64 64 64 64 64 64
64 64 64 64 64 64 64 64 54 0 0 0 0 0 0 0 0 0 0 15 58 64 64 64 64 64 64 64 64 64 64 64 64 64 64 64 64 64 64 64 64 64 64 61 17 0 0 0 0 0 0 0 0 0 0 50 64 64 64 64 64 64 64 64
64 64 64 64 64 64 64 57 0 0 0 25 49 64 64 62 46 16 0 0 14 62 64 64 64 64 64 64 64 64 64 64 64 64 64 64 64 64 64 64 64 64 63 16 0 0 15 44 62 64 64 51 27 0 0 0 53 64 64 64 64 64 64 64
64 64 64 64 64 64 64 14 0 0 47 64 64 64 64 64 64 64 35 0 0 29 64 64 64 64 64 64 64 64 64 64 64 64 64 64 64 64 64 64 64 64 32 0 0 30 64 64 64 64 64 64 64 48 0 0 0 63 64 64 64 64 64 64
64 64 64 64 64 64 44 0 0 43 64 64 64 64 64 64 64 64 64 30 0 0 57 64 64 64 64 64 64 64 64 64 64 64 64 64 64 64 64 64 64 61 0 0 25 64 64 64 64 64 64 64 64 64 47 0 0 40 64 64 64 64 64 64
64 64 64 64 64 64 20 0 19 64 64 64 64 64 64 64 64 64 64 62 0 0 33 64 64 64 64 64 64 64 64 64 64 64 64 64 64 64 64 64 64 38 0 0 61 64 64 64 64 64 64 64 64 64 64 23 0 17 64 64 64 64 64 64
64 64 64 64 64 64 0 0 45 64 64 64 64 64 64 64 64 64 64 64 54 48 54 64 64 64 64 64 64 64 64 64 64 64 64 64 64 64 64 64 64 54 48 52 64 64 64 64 64 64 64 64 64 64 64 46 0 0 64 64 64 64 64 64
64 64 64 64 64 64 0 0 56 64 64 64 64 24 0 36 64 64 64 64 64 64 64 64 64 64 64 64 64 64 64 64 64 64 64 64 64 64 64 64 64 64 64 64 64 64 64 64 41 0 21 64 64 64 64 61 0 0 59 64 64 64 64 64
64 64 64 64 64 64 0 0 56 64 64 64 64 0 0 17 64 64 64 64 64 64 64 64 64 64 64 64 64 64 64 64 64 64 64 64 64 64 64 64 64 64 64 64 64 64 64 64 17 0 0 60 64 64 64 64 0 0 60 64 64 64 64 64
64 64 64 64 64 64 0 0 51 64 64 64 64 38 17 46 64 64 64 64 60 56 59 64 64 64 64 64 64 64 64 64 64 64 64 64 64 64 64 64 64 60 56 59 64 64 64 64 49 17 33 64 64 64 64 53 0 0 64 64 64 64 64 64
64 64 64 64 64 64 22 0 31 64 64 64 64 64 64 64 64 64 64 64 17 0 35 64 64 64 64 64 64 64 64 64 64 64 64 64 64 64 64 64 64 39 0 14 64 64 64 64 64 64 64 64 64 64 64 34 0 16 64 64 64 64 64 64
64 64 64 64 64 64 45 0 0 58 64 64 64 64 64 64 64 64 64 47 0 0 57 64 64 64 64 64 64 64 64 64 64 64 64 64 64 64 64 64 64 61 0 0 44 64 64 64 64 64 64 64 64 64 60 0 0 41 64 64 64 64 64 64
64 64 64 64 64 64 64 16 0 15 61 64 64 64 64 64 64 64 55 0 0 29 64 64 64 64 64 64 64 64 64 64 64 64 64 64 64 64 64 64 64 64 34 0 0 54 64 64 64 64 64 64 64 62 17 0 13 63 64 64 64 64 64 64
64 64 64 64 64 64 64 56 0 0 13 50 64 64 64 64 64 43 0 0 15 62 64 64 64 64 64 64 64 64 64 64 64 64 64 64 64 64 64 64 64 64 64 19 0 0 41 64 64 64 64 64 54 13 0 0 55 64 64 64 64 64 64 64
64 64 64 64 64 64 32 32 23 0 0 0 0 29 32 26 0 0 0 0 47 64 64 64 64 64 64 64 64 64 64 64 64 64 64 64 64 64 64 64 64 40 32 29 0 0 0 0 25 32 29 14 0 0 0 35 63 64 64 64 64 64 64 64
64 64 64 64 64 64 0 0 0 0 0 0 0 0 0 0 0 0 0 0 0 29 64 64 64 64 64 64 64 64 64 64 64 64 64 64 64 64 64 64 64 16 0 0 0 0 0 0 0 0 0 0 0 0 0 0 15 61 64 64 64 64 64 64
64 64 64 64 64 63 32 32 32 32 32 32 32 32 32 32 32 32 32 29 0 0 43 64 64 64 64 64 64 64 64 64 64 64 64 64 64 64 64 64 64 40 32 32 32 32 32 32 32 32 32 32 32 32 32 0 0 25 64 64 64 64 64 64
64 64 64 64 64 64 64 64 64 64 64 64 64 64 64 64 64 64 64 64 40 0 17 64 64 64 64 64 64 64 64 64 64 64 64 64 64 64 64 64 64 64 64 64 64 64 64 64 64 64 64 64 64 64 64 56 0 0 62 64 64 64 64 64
64 64 64 64 64 64 64 64 64 64 64 64 64 64 64 64 64 64 64 64 61 0 0 64 64 64 64 64 64 64 64 64 64 64 64 64 64 64 64 64 64 64 64 64 64 64 64 64 64 64 64 64 64 64 64 64 0 0 56 64 64 64 64 64
64 64 64 64 64 64 64 64 64 64 64 64 64 64 64 64 64 64 64 64 53 0 0 64 64 64 64 64 64 64 64 64 64 64 64 64 64 64 64 64 64 64 64 64 64 64 64 64 64 64 64 64 64 64 64 64 0 0 58 64 64 64 64 64
64 64 64 64 64 64 64 64 64 64 64 64 64 64 64 64 64 64 64 58 15 0 29 64 64 64 64 64 64 64 64 64 64 64 64 64 64 64 64 64 64 64 64 64 64 64 64 64 64 64 64 64 64 64 62 28 0 0 64 64 64 64 64 64
64 64 64 64 64 64 64 64 64 64 64 64 64 64 64 64 64 64 64 21 0 0 60 64 64 64 64 64 64 64 64 64 64 64 64 64 64 64 64 64 64 64 64 64 64 64 64 64 64 64 64 64 64 64 41 0 0 50 64 64 64 64 64 64
64 64 64 64 64 64 64 64 64 64 64 64 64 64 64 64 64 64 64 34 24 59 64 64 64 64 64 64 64 64 64 64 64 64 64 64 64 64 64 64 64 64 64 64 64 64 64 64 64 64 64 64 64 64 50 18 51 64 64 64 64 64 64 64
64 64 64 64 64 64 64 64 64 64 64 64 64 64 64 64 64 64 64 64 64 64 64 64 64 64 64 64 64 64 64 64 64 64 64 64 64 64 64 64 64 64 64 64 64 64 64 64 64 64 64 64 64 64 64 64 64 64 64 64 64 64 64 64
64 64 64 64 64 64 64 64 64 64 64 64 64 64 64 64 64 64 64 64 64 64 64 64 64 64 64 64 64 64 64 64 64 64 64 64 64 64 64 64 64 64 64 64 64 64 64 64 64 64 64 64 64 64 64 64 64 64 64 64 64 64 64 64