0 0 0 0 0 0 0 0 0 0 0 0 0 0 0 0 0 0 0 0 0 0 0 0 0 0 0 0 0 0 0 0 0 0 0 0 0 0 0 0 0 0 0 0 0 0 0 0 0 0 0 0 0 0 0 0 0 0 0 0 0 0 0 0
0 0 0 0 0 0 0 0 0 0 0 0 0 0 0 0 0 0 0 0 0 0 0 0 0 0 0 0 0 0 0 0 0 0 0 0 0 0 0 0 0 0 0 0 0 0 0 0 0 0 0 0 0 170 181 0 0 0 0 0 0 0 0 0
0 0 0 0 158 219 190 0 0 0 0 0 0 0 0 0 0 0 0 0 0 0 0 0 0 0 0 0 0 0 0 0 0 0 0 0 0 213 252 203 0 0 0 0 0 0 0 0 0 0 0 0 255 256 256 256 156 0 0 0 0 0 0 0
0 0 0 218 256 256 256 253 0 0 0 0 0 0 0 0 0 0 0 0 0 0 0 151 134 0 0 0 0 0 0 0 0 0 0 0 253 256 256 256 246 0 0 0 0 0 0 0 0 0 0 230 256 256 256 256 256 0 0 0 0 0 0 0
0 0 0 256 256 256 256 256 191 0 0 0 0 0 0 0 0 0 0 0 0 145 256 256 256 246 0 0 0 0 0 0 0 0 0 167 256 256 256 256 256 157 0 0 0 0 0 0 0 0 0 256 256 256 256 256 256 0 0 0 0 0 0 0
0 0 0 256 256 242 208 208 197 0 0 0 0 0 0 0 0 0 0 0 0 224 224 254 256 256 204 0 0 0 0 0 0 0 0 184 256 256 237 152 128 200 256 256 256 256 229 224 224 224 208 128 128 158 240 240 241 0 0 0 0 0 0 0
0 0 128 256 256 244 160 160 184 256 256 256 256 256 256 256 256 256 256 256 207 0 0 210 256 256 252 0 0 0 0 0 0 0 0 0 256 151 165 256 256 0 0 0 0 0 0 128 128 128 169 256 256 250 224 224 218 0 0 0 0 0 0 0
0 0 0 256 256 256 256 256 224 0 0 0 0 0 0 0 0 0 0 0 0 256 253 256 256 256 214 0 0 0 0 0 0 0 0 0 172 128 160 256 145 0 0 0 0 0 0 0 0 0 0 256 256 256 256 256 256 0 0 0 0 0 0 0
0 0 0 256 256 220 184 256 177 0 0 0 0 0 0 0 0 0 0 0 0 155 176 256 256 198 0 0 0 0 0 0 0 0 0 0 0 173 146 0 0 0 0 0 0 0 0 0 0 0 0 0 0 0 195 256 256 204 0 0 0 0 0 0
0 0 0 188 256 208 160 241 0 0 0 0 0 0 0 0 0 0 0 0 0 0 0 183 166 0 231 152 0 0 0 0 0 0 0 0 0 210 0 0 0 0 0 0 0 0 0 0 0 0 0 156 192 192 197 189 192 151 0 0 0 0 0 0
0 0 0 0 0 220 142 0 0 0 0 0 0 0 0 0 0 0 0 0 0 178 0 0 0 0 0 218 228 0 0 0 0 0 0 0 0 229 0 0 0 0 0 0 0 0 0 0 0 0 0 0 192 192 192 227 224 224 225 0 0 0 0 0
0 0 0 0 0 224 128 0 0 0 0 0 0 0 0 0 0 0 0 0 168 0 0 0 0 0 0 0 134 239 135 0 0 0 0 0 0 216 0 0 0 0 0 0 0 0 0 0 0 0 0 0 242 186 256 256 229 224 223 0 0 0 0 0
0 0 0 0 0 224 128 0 0 0 0 0 0 0 0 0 0 0 227 241 0 0 0 0 0 0 0 0 0 0 0 0 0 0 0 189 151 154 0 0 0 0 0 0 0 0 0 0 0 0 0 0 0 141 256 256 138 0 0 0 0 0 0 0
0 0 0 0 0 224 128 0 0 0 0 0 0 0 0 0 172 254 159 0 0 0 0 0 0 0 0 0 0 0 131 137 225 256 256 256 128 0 256 233 0 0 0 0 0 0 0 0 0 0 0 0 0 0 195 256 134 0 0 0 0 0 0 0
0 0 0 0 0 224 128 0 0 0 0 153 229 223 224 207 192 0 0 0 0 0 0 0 0 0 0 0 0 0 180 0 256 256 256 256 128 0 256 256 256 0 0 0 0 0 0 0 0 0 0 0 0 0 0 0 0 208 0 0 0 0 0 0
0 0 0 0 0 224 128 0 0 0 192 256 256 240 256 0 0 0 0 0 0 0 0 0 0 0 0 0 0 0 192 0 256 256 256 256 128 0 256 255 256 234 0 0 0 0 0 0 0 0 0 0 0 0 0 0 0 181 0 0 0 0 0 0
0 0 0 0 0 224 128 0 0 0 256 256 256 240 254 210 214 0 0 0 0 0 0 0 0 0 0 0 0 159 160 160 218 256 256 256 128 0 256 256 256 256 0 0 0 0 0 0 0 0 0 0 0 0 0 0 0 207 0 0 0 0 0 0
0 0 0 0 0 224 128 0 0 0 256 256 256 248 256 256 256 0 0 0 0 0 0 0 0 0 0 0 0 208 208 208 215 240 256 256 159 190 240 240 240 240 152 0 0 0 0 0 0 0 0 0 0 0 0 0 0 129 226 0 0 0 0 0
0 0 0 0 0 220 193 208 208 209 224 224 224 143 0 0 0 214 208 208 208 208 208 208 208 208 208 208 172 0 0 0 0 0 228 256 250 256 256 256 256 256 195 0 0 0 0 0 0 0 0 0 0 0 0 0 0 0 164 0 0 0 0 0
0 0 0 0 0 0 144 144 144 148 128 128 128 138 144 144 151 151 144 144 144 144 144 144 144 144 144 144 149 144 144 144 144 144 151 221 256 256 256 256 256 256 197 0 0 0 0 0 0 0 0 0 0 0 0 0 0 0 222 0 0 0 0 0
0 0 0 0 0 0 0 0 0 0 256 256 256 256 256 256 256 0 0 0 0 0 0 0 0 0 0 0 0 256 256 256 256 256 256 245 256 256 256 256 256 256 204 0 0 0 0 0 0 0 0 0 0 0 0 0 0 185 226 162 150 0 0 0
0 0 0 0 0 0 0 0 0 0 256 256 256 256 229 192 203 0 0 0 0 0 0 0 0 0 0 0 0 225 256 256 256 256 256 240 256 254 240 240 240 240 157 0 0 0 0 0 0 0 0 0 0 0 0 0 211 256 224 160 256 150 0 0
0 0 0 0 0 0 0 0 0 0 212 245 256 256 256 0 141 136 0 0 0 0 0 0 0 0 0 0 0 141 256 256 256 256 256 240 256 256 256 228 224 224 0 0 0 0 0 0 0 0 0 0 0 0 0 0 176 196 238 202 256 247 0 0
0 0 0 0 0 0 0 0 0 191 206 255 256 256 256 197 0 0 0 0 0 0 0 0 0 0 0 0 0 0 0 168 188 256 256 240 256 256 256 256 233 0 0 0 0 0 0 0 0 0 0 0 0 0 0 0 0 0 187 256 256 254 0 0
0 0 0 0 0 0 0 129 237 220 0 0 154 165 0 0 0 0 0 0 0 0 0 0 0 0 0 0 164 233 156 248 256 256 256 240 256 256 256 256 237 0 0 0 0 0 0 155 151 146 155 151 140 224 256 0 0 0 256 256 256 185 0 0
0 0 0 242 256 256 244 187 0 0 0 0 0 0 0 0 0 0 0 0 130 237 256 256 246 0 175 256 214 0 0 0 233 256 256 240 256 256 252 187 0 0 0 0 0 235 256 256 256 256 256 256 224 256 256 0 0 143 0 0 0 0 0 0
0 0 229 256 256 256 256 229 0 0 0 0 0 0 0 0 0 0 0 148 178 221 256 256 224 176 167 0 0 0 0 0 0 0 165 196 176 0 0 0 0 0 0 0 172 256 256 256 256 256 256 256 224 256 256 200 240 256 0 0 0 0 0 0
0 0 256 256 256 256 256 256 0 0 0 0 0 0 0 0 0 0 0 0 256 256 256 256 256 256 0 0 0 0 0 0 0 0 0 0 0 0 0 0 0 0 0 0 220 256 256 256 256 256 256 256 240 256 256 256 240 256 176 155 0 0 0 0
0 0 254 256 256 256 256 254 0 0 0 0 0 0 0 0 0 0 0 0 249 256 256 256 241 194 0 0 0 0 0 0 0 0 0 0 0 0 0 0 0 0 0 0 186 225 256 256 256 256 256 256 256 256 256 256 240 250 0 0 0 0 0 0
0 0 161 256 256 256 256 161 0 0 0 0 0 0 0 0 0 0 0 0 145 256 256 256 256 244 0 0 131 240 240 240 240 240 240 240 240 240 240 240 240 240 240 242 231 240 256 256 256 256 256 256 256 256 256 255 162 0 0 0 0 0 0 0
0 0 0 137 224 224 137 0 0 0 0 0 0 0 0 0 0 0 0 0 0 128 221 227 145 0 0 0 0 0 0 0 0 0 0 0 0 0 0 0 0 0 0 0 0 0 158 187 183 178 187 183 172 170 0 0 0 0 0 0 0 0 0 0
0 0 0 0 0 0 0 0 0 0 0 0 0 0 0 0 0 0 0 0 0 0 0 0 0 0 0 0 0 0 0 0 0 0 0 0 0 0 0 0 0 0 0 0 0 0 0 0 0 0 0 0 0 0 0 0 0 0 0 0 0 0 0 0