0 0 0 0 0 0 0 0 0 0 0 0 0 0 0 0 0 0 0 0 0 0 0 0 0 0 0 0 0 0 0 0 0 0 0 0 0 0 0 0 0 0 0 0 0 0 0 0 0 0 0 0 0 0 0 0 0 0 0 0 0 0 0 0
0 0 0 0 0 0 0 0 0 0 0 0 0 0 0 0 0 0 0 0 0 0 0 0 0 0 0 0 0 0 0 0 0 0 0 0 0 0 0 0 0 0 0 0 0 0 0 0 0 0 0 0 0 0 0 0 0 0 0 0 0 0 0 0
0 0 0 0 0 0 79 128 128 133 144 144 144 145 158 160 160 160 171 176 176 176 183 192 152 144 144 144 144 144 144 128 112 109 96 93 80 75 64 57 0 0 0 0 0 0 0 0 0 0 0 0 0 0 0 0 0 0 0 0 0 0 0 0
0 0 0 0 0 0 224 256 252 208 208 208 201 192 192 192 189 176 176 176 176 164 237 256 256 254 208 208 208 227 256 256 244 240 249 256 256 256 256 256 256 256 256 256 256 256 256 244 240 228 224 211 208 193 192 176 176 160 112 0 0 0 0 0
0 0 0 0 0 0 203 231 254 184 0 0 0 0 0 0 0 0 0 0 0 187 256 256 256 256 79 0 0 182 256 256 203 0 0 0 0 0 0 56 243 256 124 64 78 190 216 97 112 157 256 138 144 167 256 184 176 211 240 0 0 0 0 0
0 0 0 0 0 0 192 145 62 216 244 112 0 0 0 0 0 0 0 111 245 216 180 256 256 189 223 0 66 256 225 223 245 144 0 0 0 0 0 190 232 256 80 0 0 160 192 0 0 80 256 0 0 0 256 0 0 112 240 0 0 0 0 0
0 0 0 0 0 0 192 160 0 0 133 251 202 0 0 0 0 0 198 252 133 0 226 223 256 0 247 123 205 188 160 192 97 255 78 0 0 0 130 250 70 256 80 0 0 160 192 0 0 80 256 0 0 0 256 0 0 112 240 0 0 0 0 0
0 0 0 0 0 0 192 160 0 0 0 0 204 250 130 0 121 248 207 0 0 83 255 121 256 0 128 252 255 0 160 192 0 166 236 0 0 70 254 109 0 256 80 0 0 160 192 0 0 80 256 0 0 0 256 0 0 112 240 0 0 0 0 0
0 0 0 0 0 0 191 160 0 0 0 0 0 113 245 245 249 124 0 0 0 192 185 80 256 0 0 247 162 0 160 192 0 0 220 193 0 236 170 0 0 256 80 0 0 160 192 0 0 80 256 0 0 0 256 0 0 112 240 0 0 0 0 0
0 0 0 0 0 0 176 161 0 0 0 0 0 131 251 200 0 0 0 0 0 256 78 80 256 0 0 240 112 0 160 192 0 0 0 250 238 219 0 0 0 256 80 0 0 160 192 0 0 80 256 0 0 0 256 0 0 112 240 0 0 0 0 0
0 0 0 0 0 0 176 176 0 0 0 55 213 246 113 0 0 0 0 0 153 222 0 80 256 0 0 240 112 0 160 192 0 0 0 175 256 97 0 0 0 256 124 64 64 184 208 64 64 124 256 0 0 0 256 0 0 112 240 0 0 0 0 0
0 0 0 0 0 0 176 176 0 0 142 253 190 0 0 0 0 0 0 0 245 114 0 80 256 0 0 240 112 0 160 192 0 0 79 255 218 229 0 0 0 256 256 256 256 256 256 256 256 256 256 0 0 113 256 127 0 112 240 0 0 0 0 0
0 0 0 0 0 0 176 176 64 219 242 104 0 0 0 0 0 0 0 113 247 0 0 80 256 0 0 240 112 0 160 192 0 0 238 162 0 229 179 0 0 256 102 0 0 172 200 0 0 102 256 0 0 246 219 245 0 112 240 0 0 0 0 0
0 0 0 0 0 0 163 241 255 182 0 0 0 0 0 0 0 0 0 220 154 0 0 80 256 0 0 240 112 0 160 192 0 203 214 0 0 62 253 113 0 256 80 0 0 160 192 0 0 80 256 0 190 215 0 228 162 112 240 0 0 0 0 0
0 0 0 0 0 0 160 256 140 0 0 0 0 0 0 0 0 0 74 256 0 0 0 80 256 0 0 240 112 0 160 192 146 245 0 0 0 0 127 250 67 256 80 0 0 160 192 0 0 80 256 123 253 56 0 93 255 163 240 0 0 0 0 0
0 0 0 0 0 0 160 256 241 55 0 0 0 0 0 0 0 0 183 195 0 0 0 80 256 0 0 240 112 0 160 241 256 92 0 0 0 0 0 193 229 256 80 0 0 160 192 0 0 80 256 248 140 0 0 0 198 254 240 0 0 0 0 0
0 0 0 0 0 0 160 243 178 241 55 0 0 0 0 0 0 0 254 86 0 0 0 80 256 64 64 244 148 64 184 256 198 64 64 64 64 64 64 91 252 256 113 0 0 178 204 0 0 113 256 237 56 0 0 0 107 256 240 0 0 0 0 0
0 0 0 0 0 0 147 240 0 178 241 77 0 0 0 0 0 157 228 0 0 0 0 80 256 256 256 256 256 256 256 256 256 256 256 256 256 256 256 256 256 256 256 256 256 256 256 256 256 256 256 256 256 256 256 256 256 256 240 0 0 0 0 0
0 0 0 0 0 0 144 240 0 0 227 256 256 256 256 256 256 256 183 0 0 0 0 87 256 0 0 242 130 0 172 256 242 68 0 0 0 0 0 102 255 256 113 0 0 178 204 0 0 113 256 253 89 0 0 0 163 256 240 0 0 0 0 0
0 0 0 0 0 0 144 240 0 106 255 101 0 0 0 0 0 98 256 84 0 0 0 96 256 0 0 240 112 0 160 206 201 228 0 0 0 0 68 247 178 256 80 0 0 160 192 0 0 80 256 213 217 0 0 65 253 217 240 0 0 0 0 0
0 0 0 0 0 0 144 240 62 250 132 0 0 0 0 0 0 0 160 235 0 0 0 96 256 0 0 240 112 0 160 192 0 202 228 0 0 66 246 165 0 256 80 0 0 160 192 0 0 80 256 0 232 184 0 233 175 113 240 0 0 0 0 0
0 0 0 0 0 0 135 248 234 179 0 0 0 0 0 0 0 0 0 227 176 0 0 96 256 0 0 240 112 0 160 192 0 0 211 221 93 246 165 0 0 256 80 0 0 160 192 0 0 80 256 0 60 250 238 219 0 112 240 0 0 0 0 0
0 0 0 0 0 0 128 256 218 0 0 0 0 0 0 0 0 0 0 71 255 91 0 96 256 0 0 240 112 0 160 192 0 0 0 217 256 171 0 0 0 256 212 192 192 232 240 192 192 211 256 0 0 125 256 0 0 112 240 0 0 0 0 0
0 0 0 0 0 0 128 256 254 202 126 0 0 0 0 0 0 0 0 0 153 239 0 96 256 0 0 250 144 0 160 192 0 0 66 246 244 220 0 0 0 256 190 160 160 220 232 160 160 189 256 0 0 96 256 0 0 112 240 0 0 0 0 0
0 0 0 0 0 0 128 229 84 160 233 256 229 154 77 0 0 0 0 0 0 223 180 97 256 0 181 245 253 69 160 192 0 66 246 166 0 218 220 0 0 256 80 0 0 160 192 0 0 80 256 0 0 96 256 0 0 112 240 0 0 0 0 0
0 0 0 0 0 0 123 224 0 0 0 56 130 207 256 248 182 106 0 0 0 64 254 193 256 93 255 65 173 234 186 192 66 246 167 0 0 0 220 211 0 256 80 0 0 160 192 0 0 80 256 0 0 96 256 0 0 112 240 0 0 0 0 0
0 0 0 0 0 0 112 229 0 0 0 0 0 0 0 103 179 247 256 210 133 59 145 256 256 235 154 0 0 221 256 230 246 169 0 0 0 0 0 220 220 256 80 0 0 160 192 0 0 80 256 0 0 96 256 0 0 112 240 0 0 0 0 0
0 0 0 0 0 0 112 246 96 96 96 96 92 87 80 80 80 88 156 229 256 256 244 256 256 253 110 96 96 145 256 256 239 116 112 112 112 119 128 156 256 256 157 112 112 202 220 112 112 157 256 121 112 166 256 112 112 175 240 0 0 0 0 0
0 0 0 0 0 0 74 251 256 256 256 256 256 256 256 256 256 256 256 256 256 256 256 256 256 256 256 256 256 256 256 241 240 240 240 240 240 240 240 240 240 240 240 240 240 240 240 240 240 240 240 240 240 240 246 240 240 240 182 0 0 0 0 0
0 0 0 0 0 0 0 0 0 0 0 0 0 0 0 0 0 0 0 0 0 0 0 0 0 0 0 0 0 0 0 0 0 0 0 0 0 0 0 0 0 0 0 0 0 0 0 0 0 0 0 0 0 0 0 0 0 0 0 0 0 0 0 0
0 0 0 0 0 0 0 0 0 0 0 0 0 0 0 0 0 0 0 0 0 0 0 0 0 0 0 0 0 0 0 0 0 0 0 0 0 0 0 0 0 0 0 0 0 0 0 0 0 0 0 0 0 0 0 0 0 0 0 0 0 0 0 0
0 0 0 0 0 0 0 0 0 0 0 0 0 0 0 0 0 0 0 0 0 0 0 0 0 0 0 0 0 0 0 0 0 0 0 0 0 0 0 0 0 0 0 0 0 0 0 0 0 0 0 0 0 0 0 0 0 0 0 0 0 0 0 0