0 0 0 0 0 0 0 0 0 0 0 0 0 0 0 0 0 0 0 0 0 0 0 0 0 0 0 0 0 0 0 0 0 0 0 0 0 0 0 0 0 0 0 0 0 0 0 0 0 0 0 0 0 0 0 0 0 0 0 0 0 0 0 0
0 0 0 0 0 0 0 0 0 0 0 0 0 0 0 0 0 0 0 0 0 0 0 0 0 0 0 0 0 0 0 0 0 0 0 0 0 0 0 0 0 0 0 0 0 0 0 0 0 0 0 0 0 0 0 0 0 0 0 0 0 0 0 0
0 0 0 0 0 0 0 0 0 0 0 0 0 0 0 0 0 0 0 0 0 0 0 0 0 0 0 0 0 0 0 0 0 0 0 0 0 0 0 0 0 0 0 0 0 0 0 0 0 0 0 0 0 0 0 0 0 128 256 256 256 192 0 0
0 0 0 0 0 0 128 256 256 256 256 256 256 256 256 112 0 0 0 0 0 0 0 0 0 0 0 0 0 0 0 0 0 0 0 0 0 0 0 0 0 0 0 0 0 0 0 0 0 0 0 0 0 0 0 0 0 128 256 256 256 192 0 0
0 0 0 0 0 0 128 256 256 256 256 256 256 256 256 112 0 0 0 0 0 0 0 0 0 0 0 0 0 0 0 0 0 0 0 0 0 0 0 0 0 0 0 0 0 0 0 0 0 0 0 0 0 0 0 0 0 128 256 256 256 192 0 0
0 0 0 0 0 0 128 256 256 256 256 256 256 256 256 112 0 0 0 0 0 0 0 0 0 0 0 0 0 0 0 0 0 0 0 0 0 0 0 0 0 0 0 0 0 0 0 0 0 0 0 80 0 0 0 0 0 128 256 256 256 192 0 0
0 0 0 0 0 0 128 256 256 256 256 256 256 256 256 202 160 160 160 160 160 160 160 160 160 160 160 160 160 160 160 160 160 160 160 160 160 160 160 160 160 160 160 160 160 160 160 160 160 160 214 256 135 80 80 80 80 167 256 256 256 192 0 0
0 0 0 0 0 0 128 256 256 256 256 256 256 256 256 193 144 144 144 144 144 144 144 144 144 144 172 256 165 144 144 144 144 144 144 144 144 144 144 144 144 144 151 256 151 144 144 144 144 144 207 256 102 0 172 172 0 144 256 256 256 192 0 0
0 0 0 0 0 0 128 256 256 256 256 256 256 256 256 112 0 0 0 0 0 0 0 0 0 0 64 256 0 0 0 0 0 0 0 0 0 0 0 0 0 60 91 256 91 75 0 0 0 0 144 256 80 0 160 160 0 128 256 256 256 192 0 0
0 0 0 0 0 0 128 256 256 256 256 256 256 256 256 112 0 0 0 0 0 0 0 0 0 0 64 256 0 0 0 0 0 0 0 0 0 0 0 0 0 192 256 256 256 240 0 0 0 0 144 256 80 0 160 160 0 128 256 256 256 192 0 0
0 0 0 0 0 0 0 96 96 206 256 116 96 96 96 0 0 0 0 0 0 0 0 0 0 0 64 256 0 0 0 0 0 0 0 0 0 0 0 0 0 192 256 256 256 240 0 0 0 0 144 256 80 0 160 160 0 128 256 256 256 192 0 0
0 0 0 0 0 0 0 0 0 176 256 0 0 0 0 0 0 0 0 0 0 0 0 0 0 0 64 256 0 0 0 0 0 0 0 0 0 0 0 0 0 192 256 256 256 240 0 0 0 0 144 256 80 0 160 160 0 128 256 256 256 192 0 0
0 0 0 0 0 0 0 0 0 176 256 0 0 0 0 0 0 0 0 0 0 0 0 0 0 0 64 256 0 0 0 0 0 0 0 0 0 0 0 0 0 180 245 252 240 225 0 0 0 0 144 256 80 0 160 160 0 128 256 256 256 192 0 0
0 0 0 0 0 0 0 0 0 176 256 0 0 0 0 0 0 0 0 0 0 0 0 0 0 0 88 256 74 0 0 0 0 0 0 0 0 0 0 0 0 0 80 208 0 0 0 0 0 0 144 256 80 0 160 160 0 128 256 256 256 192 0 0
0 0 0 0 0 0 0 0 0 176 256 0 0 0 0 0 0 0 0 0 0 0 0 0 160 256 256 256 256 256 256 256 256 256 256 256 256 144 0 0 0 0 80 232 128 128 128 128 128 128 200 256 80 0 160 160 0 128 256 256 256 192 0 0
0 0 0 0 0 0 0 0 0 176 256 102 80 80 80 80 80 80 80 80 80 80 80 80 190 256 256 256 256 256 256 256 256 256 256 256 256 144 0 0 0 0 80 232 128 128 128 128 128 128 137 144 0 0 160 160 0 128 256 256 256 192 0 0
0 0 0 0 0 0 0 0 0 176 256 256 256 256 256 256 256 256 256 256 256 256 256 256 256 256 256 256 256 256 256 256 256 256 256 256 256 144 0 0 0 0 80 208 0 0 0 0 0 0 0 0 0 0 160 160 0 128 256 256 256 192 0 0
0 0 0 0 0 0 0 0 0 176 256 88 64 64 64 64 64 64 64 64 64 64 64 64 184 256 256 256 256 256 256 256 256 256 256 256 256 144 0 0 0 0 80 208 0 0 0 0 0 0 80 80 0 0 160 160 0 128 256 256 256 192 0 0
0 0 0 0 0 0 0 0 0 176 256 0 0 0 0 0 0 0 0 0 0 0 0 0 160 256 256 256 256 256 256 256 256 256 256 256 256 144 0 0 0 0 80 208 0 0 0 0 0 80 256 256 112 0 160 160 0 128 256 256 256 192 0 0
0 0 0 0 0 0 0 0 0 176 256 0 0 0 0 0 0 0 0 0 0 0 0 0 80 128 192 256 128 128 128 128 128 200 248 128 128 72 0 0 0 0 80 208 0 0 0 0 0 80 256 256 148 64 184 160 0 128 256 256 256 192 0 0
0 56 224 224 224 224 224 224 224 246 256 228 224 224 224 224 224 224 224 224 224 224 210 0 0 0 128 256 0 0 0 0 0 144 240 0 0 0 0 0 0 0 80 253 240 240 240 240 240 245 256 256 256 256 256 160 0 128 256 256 256 192 0 0
0 64 256 256 256 256 256 256 256 256 256 256 256 256 256 256 256 256 256 256 256 256 240 0 0 0 128 256 0 0 0 0 0 144 240 0 0 0 0 0 0 0 80 232 128 128 128 128 128 168 256 256 120 0 0 0 0 128 256 256 256 192 0 0
0 64 256 256 256 256 256 256 256 256 256 256 256 256 256 256 256 256 256 256 256 256 240 0 0 0 128 256 0 0 0 0 0 144 240 0 0 0 0 0 0 0 80 208 0 0 0 0 0 80 256 256 229 208 208 208 208 232 256 256 256 192 0 0
0 64 256 256 256 256 256 256 256 256 256 256 256 256 256 256 256 256 256 256 256 256 240 0 0 0 128 256 0 0 0 0 0 144 240 0 0 0 0 0 0 0 80 208 0 0 0 0 0 80 256 256 184 128 128 128 128 192 256 256 256 192 0 0
0 64 256 256 256 256 256 256 256 256 256 256 256 256 256 256 256 256 256 256 256 256 244 64 64 64 160 256 64 64 64 64 64 172 244 64 64 64 64 64 64 64 124 208 0 0 0 0 0 0 0 0 0 0 0 0 0 128 256 256 256 192 0 0
0 64 256 256 256 256 256 256 256 256 256 256 256 256 256 256 256 256 256 256 256 256 256 256 256 256 256 256 256 256 256 256 256 256 256 256 256 256 256 256 256 256 256 253 240 240 240 240 240 240 240 240 240 240 240 240 240 248 256 256 256 192 0 0
0 64 256 256 256 256 256 256 256 256 256 256 256 256 256 256 256 256 256 256 256 256 254 224 224 224 224 224 224 224 224 224 224 224 224 224 224 224 224 224 224 224 224 206 128 128 128 128 128 128 128 128 128 128 128 128 128 192 256 256 256 192 0 0
0 64 256 256 256 256 256 256 256 256 256 256 256 256 256 256 256 256 256 256 256 256 240 0 0 0 0 0 0 0 0 0 0 0 0 0 0 0 0 0 0 0 0 0 0 0 0 0 0 0 0 0 0 0 0 0 0 128 256 256 256 192 0 0
0 64 256 256 256 256 256 256 256 256 256 256 256 256 256 256 256 256 256 256 256 256 240 0 0 0 0 0 0 0 0 0 0 0 0 0 0 0 0 0 0 0 0 0 0 0 0 0 0 0 0 0 0 0 0 0 0 64 128 128 128 96 0 0
0 64 256 256 256 256 256 256 256 256 256 256 256 256 256 256 256 256 256 256 256 256 240 0 0 0 0 0 0 0 0 0 0 0 0 0 0 0 0 0 0 0 0 0 0 0 0 0 0 0 0 0 0 0 0 0 0 0 0 0 0 0 0 0
0 0 176 176 176 176 176 176 176 176 176 176 176 176 176 176 176 176 176 176 176 176 165 0 0 0 0 0 0 0 0 0 0 0 0 0 0 0 0 0 0 0 0 0 0 0 0 0 0 0 0 0 0 0 0 0 0 0 0 0 0 0 0 0
0 0 0 0 0 0 0 0 0 0 0 0 0 0 0 0 0 0 0 0 0 0 0 0 0 0 0 0 0 0 0 0 0 0 0 0 0 0 0 0 0 0 0 0 0 0 0 0 0 0 0 0 0 0 0 0 0 0 0 0 0 0 0 0