0 0 0 0 0 0 0 0 0 0 0 0 0 0 0 0 0 0 0 0 0 0 0 0 0 0 0 0 0 0 0 0 0 0 0 0 0 0 0 0 0 0 0 0 0 0 0 0 0 0 0 0 0 0 0 0 0 0 0 0 0 0 0 0
0 0 0 0 0 0 0 0 0 0 0 0 0 0 0 0 0 0 0 0 0 0 0 0 0 0 0 0 0 0 0 0 0 0 0 0 0 0 0 0 0 0 0 0 0 0 0 0 0 0 0 0 0 0 0 0 0 0 0 0 0 0 0 0
0 0 0 0 0 0 0 0 0 0 0 0 0 0 0 0 0 0 0 0 0 0 0 0 0 0 0 0 0 0 0 0 0 0 0 0 0 0 0 0 0 0 0 0 0 0 0 0 0 0 0 0 0 0 0 0 0 32 64 64 64 48 0 0
0 0 0 0 0 0 32 64 64 64 64 64 64 64 64 32 0 0 0 0 0 0 0 0 0 0 0 0 0 0 0 0 0 0 0 0 0 0 0 0 0 0 0 0 0 0 0 0 0 0 0 0 0 0 0 0 0 32 64 64 64 48 0 0
0 0 0 0 0 0 32 64 64 64 64 64 64 64 64 32 0 0 0 0 0 0 0 0 0 0 0 0 0 0 0 0 0 0 0 0 0 0 0 0 0 0 0 0 0 0 0 0 0 0 0 0 0 0 0 0 0 32 64 64 64 48 0 0
0 0 0 0 0 0 32 64 64 64 64 64 64 64 64 32 0 0 0 0 0 0 0 0 0 0 0 0 0 0 0 0 0 0 0 0 0 0 0 0 0 0 0 0 0 0 0 0 0 0 0 24 0 0 0 0 0 32 64 64 64 48 0 0
0 0 0 0 0 0 32 64 64 64 64 64 64 64 64 52 40 40 40 40 40 40 40 40 40 40 40 40 40 40 40 40 40 40 40 40 40 40 40 40 40 40 40 40 40 40 40 40 40 40 52 64 49 40 40 40 40 52 64 64 64 48 0 0
0 0 0 0 0 0 32 64 64 64 64 64 64 64 64 48 32 32 32 32 32 32 32 32 32 32 40 64 40 32 32 32 32 32 32 32 32 32 32 32 32 32 32 64 36 32 32 32 32 32 48 64 49 40 55 55 40 52 64 64 64 48 0 0
0 0 0 0 0 0 32 64 64 64 64 64 64 64 64 32 0 0 0 0 0 0 0 0 0 0 16 64 16 0 0 0 0 0 0 0 0 0 0 0 0 18 24 64 29 24 0 0 0 0 32 64 24 0 40 40 0 32 64 64 64 48 0 0
0 0 0 0 0 0 32 64 64 64 64 64 64 64 64 32 0 0 0 0 0 0 0 0 0 0 16 64 16 0 0 0 0 0 0 0 0 0 0 0 0 48 64 64 64 64 0 0 0 0 32 64 24 0 40 40 0 32 64 64 64 48 0 0
0 0 0 0 0 0 0 24 24 49 64 29 24 24 24 0 0 0 0 0 0 0 0 0 0 0 16 64 16 0 0 0 0 0 0 0 0 0 0 0 0 48 64 64 64 64 0 0 0 0 32 64 24 0 40 40 0 32 64 64 64 48 0 0
0 0 0 0 0 0 0 0 0 40 64 0 0 0 0 0 0 0 0 0 0 0 0 0 0 0 16 64 16 0 0 0 0 0 0 0 0 0 0 0 0 48 64 64 64 64 0 0 0 0 32 64 24 0 40 40 0 32 64 64 64 48 0 0
0 0 0 0 0 0 0 0 0 40 64 0 0 0 0 0 0 0 0 0 0 0 0 0 0 0 16 64 16 0 0 0 0 0 0 0 0 0 0 0 0 42 58 62 56 56 0 0 0 0 32 64 24 0 40 40 0 32 64 64 64 48 0 0
0 0 0 0 0 0 0 0 0 40 64 0 0 0 0 0 0 0 0 0 0 0 0 0 0 0 22 64 22 0 0 0 0 0 0 0 0 0 0 0 0 0 16 56 0 0 0 0 0 0 32 64 24 0 40 40 0 32 64 64 64 48 0 0
0 0 0 0 0 0 0 0 0 40 64 0 0 0 0 0 0 0 0 0 0 0 0 0 40 64 64 64 64 64 64 64 64 64 64 64 64 40 0 0 0 0 16 60 32 32 32 32 32 32 48 64 24 0 40 40 0 32 64 64 64 48 0 0
0 0 0 0 0 0 0 0 0 40 64 29 24 24 24 24 24 24 24 24 24 24 24 24 49 64 64 64 64 64 64 64 64 64 64 64 64 40 0 0 0 0 16 60 32 32 32 32 32 32 32 32 0 0 40 40 0 32 64 64 64 48 0 0
0 0 0 0 0 0 0 0 0 40 64 64 64 64 64 64 64 64 64 64 64 64 64 64 64 64 64 64 64 64 64 64 64 64 64 64 64 40 0 0 0 0 16 56 0 0 0 0 0 0 0 0 0 0 40 40 0 32 64 64 64 48 0 0
0 0 0 0 0 0 0 0 0 40 64 22 16 16 16 16 16 16 16 16 16 16 16 16 46 64 64 64 64 64 64 64 64 64 64 64 64 40 0 0 0 0 16 56 0 0 0 0 0 0 24 24 0 0 40 40 0 32 64 64 64 48 0 0
0 0 0 0 0 0 0 0 0 40 64 0 0 0 0 0 0 0 0 0 0 0 0 0 40 64 64 64 64 64 64 64 64 64 64 64 64 40 0 0 0 0 16 56 0 0 0 0 0 16 64 64 32 0 40 40 0 32 64 64 64 48 0 0
0 0 0 0 0 0 0 0 0 40 64 0 0 0 0 0 0 0 0 0 0 0 0 0 20 32 48 64 32 32 32 32 32 48 64 32 32 20 0 0 0 0 16 56 0 0 0 0 0 16 64 64 40 16 46 40 0 32 64 64 64 48 0 0
0 14 56 56 56 56 56 56 56 61 64 57 56 56 56 56 56 56 56 56 56 56 56 0 0 0 32 64 0 0 0 0 0 32 64 0 0 0 0 0 0 0 16 64 64 64 64 64 64 64 64 64 64 64 64 40 0 32 64 64 64 48 0 0
0 16 64 64 64 64 64 64 64 64 64 64 64 64 64 64 64 64 64 64 64 64 64 0 0 0 32 64 0 0 0 0 0 32 64 0 0 0 0 0 0 0 16 60 32 32 32 32 32 40 64 64 31 0 0 0 0 32 64 64 64 48 0 0
0 16 64 64 64 64 64 64 64 64 64 64 64 64 64 64 64 64 64 64 64 64 64 0 0 0 32 64 0 0 0 0 0 32 64 0 0 0 0 0 0 0 16 56 0 0 0 0 0 16 64 64 40 24 24 24 24 40 64 64 64 48 0 0
0 16 64 64 64 64 64 64 64 64 64 64 64 64 64 64 64 64 64 64 64 64 64 0 0 0 32 64 0 0 0 0 0 32 64 0 0 0 0 0 0 0 16 56 0 0 0 0 0 0 48 48 48 48 48 48 48 56 64 64 64 48 0 0
0 16 64 64 64 64 64 64 64 64 64 64 64 64 64 64 64 64 64 64 64 64 64 16 16 16 40 64 16 16 16 16 16 40 64 16 16 16 16 16 16 16 28 56 0 0 0 0 0 0 0 0 0 0 0 0 0 32 64 64 64 48 0 0
0 16 64 64 64 64 64 64 64 64 64 64 64 64 64 64 64 64 64 64 64 64 64 64 64 64 64 64 64 64 64 64 64 64 64 64 64 64 64 64 64 64 64 64 64 64 64 64 64 64 64 64 64 64 64 64 64 64 64 64 64 48 0 0
0 16 64 64 64 64 64 64 64 64 64 64 64 64 64 64 64 64 64 64 64 64 64 56 56 56 56 56 56 56 56 56 56 56 56 56 56 56 56 56 56 56 56 53 32 32 32 32 32 32 32 32 32 32 32 32 32 48 64 64 64 48 0 0
0 16 64 64 64 64 64 64 64 64 64 64 64 64 64 64 64 64 64 64 64 64 64 0 0 0 0 0 0 0 0 0 0 0 0 0 0 0 0 0 0 0 0 0 0 0 0 0 0 0 0 0 0 0 0 0 0 32 64 64 64 48 0 0
0 16 64 64 64 64 64 64 64 64 64 64 64 64 64 64 64 64 64 64 64 64 64 0 0 0 0 0 0 0 0 0 0 0 0 0 0 0 0 0 0 0 0 0 0 0 0 0 0 0 0 0 0 0 0 0 0 16 32 32 32 24 0 0
0 16 64 64 64 64 64 64 64 64 64 64 64 64 64 64 64 64 64 64 64 64 64 0 0 0 0 0 0 0 0 0 0 0 0 0 0 0 0 0 0 0 0 0 0 0 0 0 0 0 0 0 0 0 0 0 0 0 0 0 0 0 0 0
0 0 40 40 40 40 40 40 40 40 40 40 40 40 40 40 40 40 40 40 40 40 40 0 0 0 0 0 0 0 0 0 0 0 0 0 0 0 0 0 0 0 0 0 0 0 0 0 0 0 0 0 0 0 0 0 0 0 0 0 0 0 0 0
15 0 0 0 0 0 0 0 0 0 0 0 0 0 0 0 0 0 0 0 0 0 0 0 0 0 0 0 0 0 0 0 0 0 0 0 0 0 0 0 0 0 0 0 0 0 0 0 0 0 0 0 0 0 0 0 0 0 0 0 0 0 0 0