0 0 0 0 0 0 0 0 0 0 0 0 0 0 0 0 0 0 0 0 0 0 0 0 0 0 0 0 0 0 0 0 0 0 0 0 0 0 0 0 0 0 0 0 0 0 0 0 0 0 0 0 0 0 0 0 0 0 0 0 0 0 0 0
0 0 0 0 0 0 0 0 0 0 0 0 0 0 0 0 0 0 0 0 0 0 0 0 0 0 0 0 0 0 0 0 0 0 0 0 0 0 0 0 0 0 0 0 0 0 0 0 0 0 0 0 0 0 0 0 0 0 0 0 0 0 0 0
0 0 0 0 0 0 0 0 0 0 25 40 40 40 40 40 40 40 40 40 40 40 40 40 40 40 40 40 40 40 40 40 40 40 40 40 40 40 40 40 40 40 40 40 40 40 40 40 40 40 40 40 20 0 0 0 0 0 0 0 0 0 0 0
0 0 0 0 0 0 0 0 0 0 40 64 64 64 64 64 64 64 64 64 64 64 64 64 64 64 64 64 64 64 64 64 64 64 64 64 64 64 64 64 64 64 64 64 64 64 64 64 64 64 64 64 32 0 0 0 0 0 0 0 0 0 0 0
0 0 0 0 0 0 0 0 0 0 40 64 40 16 16 16 16 16 16 16 16 16 16 16 16 16 16 16 16 16 16 16 16 16 16 16 16 16 16 16 16 16 16 16 16 16 16 16 16 16 52 64 32 0 0 0 0 0 0 0 0 0 0 0
0 0 0 0 0 0 0 0 0 0 40 64 32 0 0 0 0 0 0 0 0 0 0 0 0 0 0 0 0 0 0 0 0 0 0 0 0 0 0 0 0 0 0 0 0 0 0 0 0 0 48 64 32 0 0 0 0 0 0 0 0 0 0 0
0 0 0 0 0 0 0 0 0 0 40 64 32 0 0 0 0 0 0 0 0 0 0 0 0 0 0 0 0 0 0 0 0 0 0 0 0 0 0 0 0 0 0 0 0 0 0 0 0 0 48 64 32 0 0 0 0 0 0 0 0 0 0 0
0 0 0 0 64 64 64 64 64 64 64 64 64 64 64 64 64 64 48 0 0 0 0 0 64 64 64 64 64 64 64 64 64 64 64 64 64 24 0 0 0 0 0 48 64 64 64 64 64 64 64 64 64 64 64 64 64 64 32 0 0 0 0 0
0 0 0 0 64 64 64 64 64 64 64 64 64 64 64 64 64 64 48 0 0 0 0 0 64 64 64 64 64 64 64 64 64 64 64 64 64 24 0 0 0 0 0 48 64 64 64 64 64 64 64 64 64 64 64 64 64 64 32 0 0 0 0 0
0 0 0 0 64 64 64 64 64 64 64 64 64 64 64 64 64 64 48 0 0 0 0 0 64 64 64 64 64 64 64 64 64 64 64 64 64 24 0 0 0 0 0 48 64 64 64 64 64 64 64 64 64 64 64 64 64 64 32 0 0 0 0 0
0 0 0 0 64 64 64 64 64 64 64 64 64 64 64 64 64 64 48 0 0 0 0 0 64 64 64 64 64 64 64 64 64 64 64 64 64 24 0 0 0 0 0 48 64 64 64 64 64 64 64 64 64 64 64 64 64 64 32 0 0 0 0 0
0 0 0 0 64 64 64 64 64 64 64 64 64 64 64 64 64 64 48 0 0 0 0 0 64 64 64 64 64 64 64 64 64 64 64 64 64 24 0 0 0 0 0 48 64 64 64 64 64 64 64 64 64 64 64 64 64 64 32 0 0 0 0 0
0 0 0 0 64 64 64 64 64 64 64 64 64 64 64 64 64 64 48 0 0 0 0 0 64 64 64 64 64 64 64 64 64 64 64 64 64 24 0 0 0 0 0 48 64 64 64 64 64 64 64 64 64 64 64 64 64 64 32 0 0 0 0 0
0 0 0 0 64 64 64 64 64 64 64 64 64 64 64 64 64 64 48 0 0 0 0 0 64 64 64 64 64 64 64 64 64 64 64 64 64 24 0 0 0 0 0 48 64 64 64 64 64 64 64 64 64 64 64 64 64 64 32 0 0 0 0 0
0 0 0 0 64 64 64 64 64 64 64 64 64 64 64 64 64 64 48 0 0 0 0 0 64 64 64 64 64 64 64 64 64 64 64 64 64 24 0 0 0 0 0 48 64 64 64 64 64 64 64 64 64 64 64 64 64 64 32 0 0 0 0 0
0 0 0 0 64 64 64 64 64 64 64 64 64 64 64 64 64 64 48 0 0 0 0 0 64 64 64 64 64 64 64 64 64 64 64 64 64 24 0 0 0 0 0 48 64 64 64 64 64 64 64 64 64 64 64 64 64 64 32 0 0 0 0 0
0 0 0 0 64 64 64 64 64 64 64 64 64 64 64 64 64 64 48 0 0 0 0 0 64 64 64 64 64 64 64 64 64 64 64 64 64 24 0 0 0 0 0 48 64 64 64 64 64 64 64 64 64 64 64 64 64 64 32 0 0 0 0 0
0 0 0 0 64 64 64 64 64 64 64 64 64 64 64 64 64 64 48 0 0 0 0 0 64 64 64 64 64 64 64 64 64 64 64 64 64 24 0 0 0 0 0 48 64 64 64 64 64 64 64 64 64 64 64 64 64 64 32 0 0 0 0 0
0 0 0 0 64 64 64 64 64 64 64 64 64 64 64 64 64 64 48 0 0 0 0 0 64 64 64 64 64 64 64 64 64 64 64 64 64 24 0 0 0 0 0 48 64 64 64 64 64 64 64 64 64 64 64 64 64 64 32 0 0 0 0 0
0 0 0 0 64 64 64 64 64 64 64 64 64 64 64 64 64 64 48 0 0 0 0 0 64 64 64 64 64 64 64 64 64 64 64 64 64 24 0 0 0 0 0 48 64 64 64 64 64 64 64 64 64 64 64 64 64 64 32 0 0 0 0 0
0 0 0 0 64 64 64 64 64 64 64 64 64 64 64 64 64 64 48 0 0 0 0 0 64 64 64 64 64 64 64 64 64 64 64 64 64 24 0 0 0 0 0 48 64 64 64 64 64 64 64 64 64 64 64 64 64 64 32 0 0 0 0 0
0 0 0 0 64 64 64 64 64 64 64 64 64 64 64 64 64 64 48 0 0 0 0 0 64 64 64 64 64 64 64 64 64 64 64 64 64 24 0 0 0 0 0 48 64 64 64 64 64 64 64 64 64 64 64 64 64 64 32 0 0 0 0 0
0 0 0 0 64 64 64 64 64 64 64 64 64 64 64 64 64 64 48 0 0 0 0 0 64 64 64 64 64 64 64 64 64 64 64 64 64 24 0 0 0 0 0 48 64 64 64 64 64 64 64 64 64 64 64 64 64 64 32 0 0 0 0 0
0 0 0 0 64 64 64 64 64 64 64 64 64 64 64 64 64 64 48 0 0 0 0 0 64 64 64 64 64 64 64 64 64 64 64 64 64 24 0 0 0 0 0 48 64 64 64 64 64 64 64 64 64 64 64 64 64 64 32 0 0 0 0 0
0 0 0 0 64 64 64 64 64 64 64 64 64 64 64 64 64 64 48 0 0 0 0 0 64 64 64 64 64 64 64 64 64 64 64 64 64 24 0 0 0 0 0 48 64 64 64 64 64 64 64 64 64 64 64 64 64 64 32 0 0 0 0 0
0 64 64 64 64 64 64 64 64 64 64 64 64 64 64 64 64 64 48 0 0 0 0 0 64 64 64 64 64 64 64 64 64 64 64 64 64 24 0 0 0 0 0 48 64 64 64 64 64 64 64 64 64 64 64 64 64 64 64 64 64 48 0 0
0 64 58 48 48 48 48 48 48 48 48 48 48 48 48 48 48 48 36 0 0 24 24 24 64 64 64 64 64 64 64 64 64 64 64 64 64 39 24 24 21 0 0 43 56 56 56 56 56 56 56 56 56 56 56 56 56 56 56 56 64 48 0 0
0 64 40 0 0 0 0 0 0 0 0 0 0 0 0 0 0 0 0 0 24 64 64 64 64 64 64 64 64 64 64 64 64 64 64 64 64 64 64 64 56 0 0 0 0 0 0 0 0 0 0 0 0 0 0 0 0 0 0 0 64 48 0 0
0 64 43 0 0 0 0 0 0 0 0 0 0 0 14 0 0 0 0 0 29 64 28 16 56 56 56 56 56 56 56 56 56 56 56 56 56 26 0 50 57 0 0 0 0 0 0 0 0 0 0 0 0 0 0 0 0 0 0 0 64 48 0 0
0 64 64 64 64 64 64 64 64 64 64 64 64 64 64 64 64 64 64 64 64 64 16 0 0 0 0 0 0 0 0 0 0 0 0 0 0 0 0 48 64 64 64 64 64 64 64 64 64 64 64 64 64 64 64 64 64 64 64 64 64 48 0 0
0 48 48 48 48 48 48 48 48 48 48 48 48 48 48 48 48 48 48 48 48 48 0 0 0 0 0 0 0 0 0 0 0 0 0 0 0 0 0 36 48 48 48 48 48 48 48 48 48 48 48 48 48 48 48 48 48 48 48 48 48 40 0 0
15 0 0 0 0 0 0 0 0 0 0 0 0 0 0 0 0 0 0 0 0 0 0 0 0 0 0 0 0 0 0 0 0 0 0 0 0 0 0 0 0 0 0 0 0 0 0 0 0 0 0 0 0 0 0 0 0 0 0 0 0 0 0 0