0 0 0 0 0 0 0 0 0 0 0 0 59 86 102 112 112 103 88 63 0 0 0 0 0 0 0 0 0 0 0 0
0 0 0 0 0 0 0 0 120 185 238 256 253 230 208 232 228 198 215 240 256 242 190 127 0 0 0 0 0 0 0 0
0 0 0 0 0 101 207 256 240 166 101 52 0 72 92 196 186 94 74 0 0 67 124 196 254 217 110 0 0 0 0 0
0 0 0 68 220 256 207 88 56 133 201 250 254 211 169 145 143 146 175 256 253 211 145 65 0 134 244 229 82 0 0 0
0 0 116 254 247 107 69 199 256 256 220 202 210 0 92 112 112 104 144 242 0 112 226 256 218 91 0 181 256 137 0 0
0 92 256 248 67 142 256 256 256 140 0 165 256 256 256 256 256 256 256 253 184 60 0 153 256 256 177 0 156 256 113 0
0 231 256 124 123 256 256 256 158 0 227 256 256 256 256 256 256 256 256 256 256 255 112 0 174 256 256 163 0 221 244 0
53 256 256 150 239 256 256 256 0 159 256 256 256 256 256 256 256 256 256 256 256 256 250 0 61 256 256 254 162 217 256 74
52 256 256 161 244 256 256 256 0 155 256 256 256 256 256 256 256 256 256 256 256 256 247 0 58 256 256 256 136 198 256 73
0 230 256 111 144 256 256 256 148 0 218 256 256 256 256 256 256 256 256 256 256 252 99 0 164 256 256 182 0 213 244 0
0 86 255 243 0 173 256 256 255 124 0 129 255 256 256 256 256 256 256 246 249 149 0 137 256 256 203 0 140 256 108 0
0 0 109 253 239 82 99 226 256 256 208 147 250 61 76 96 96 88 53 0 112 250 216 256 240 123 0 157 255 130 0 0
0 0 0 60 213 256 186 70 82 165 233 256 251 195 153 129 127 130 155 198 250 241 177 97 0 111 231 224 75 0 0 0
0 0 0 0 0 92 200 256 221 142 76 53 73 104 124 208 192 126 106 78 0 0 100 173 247 210 102 0 0 0 0 0
0 0 0 0 0 0 0 0 112 177 231 256 237 204 183 226 216 176 191 216 249 235 183 118 0 0 0 0 0 0 0 0
0 0 0 0 0 0 0 0 0 0 0 0 52 76 95 96 96 96 77 55 0 0 0 0 0 0 0 0 0 0 0 0