0 0 0 0 0 0 0 0 0 0 0 0 0 0 0 0 0 0 0 0 0 0 0 0 0 0 0 0 0 0 137 0 0 144 0 0 0 0 0 0 0 0 0 0 0 0 0 0 0 0 0 0 0 0 0 0 0 0 0 0 0 0 0 0
0 0 0 0 0 0 0 0 0 0 0 0 0 0 0 0 0 0 0 0 0 166 209 247 252 227 201 174 152 147 144 176 200 143 147 168 195 219 248 256 250 214 172 0 0 0 0 0 0 0 0 0 0 0 0 0 0 0 0 0 0 0 0 0
0 0 0 0 0 0 0 0 0 0 0 0 0 0 0 0 128 199 252 223 168 0 0 0 0 0 0 0 0 0 0 131 204 0 0 0 0 0 0 0 0 0 155 209 253 254 208 137 0 0 0 0 0 0 0 0 0 0 0 0 0 0 0 0
0 0 0 0 0 0 0 0 0 0 0 0 0 135 226 242 170 0 0 0 0 0 0 133 171 203 222 214 193 178 172 0 176 180 195 212 215 194 160 0 0 0 0 0 0 0 150 228 256 234 147 0 0 0 0 0 0 0 0 0 0 0 0 0
0 0 0 0 0 0 0 0 0 0 0 188 252 179 0 0 0 0 0 181 241 220 143 0 0 0 0 0 0 0 0 0 0 0 0 0 0 0 0 0 166 228 224 161 0 0 0 0 0 155 243 256 202 0 0 0 0 0 0 0 0 0 0 0
0 0 0 0 0 0 0 0 0 200 247 145 0 0 0 0 209 254 192 0 0 0 0 0 0 0 0 0 0 0 0 0 0 0 0 0 0 0 0 0 0 0 0 0 203 244 176 0 0 0 0 0 231 256 214 0 0 0 0 0 0 0 0 0
0 0 0 0 0 0 0 166 254 158 0 0 0 152 248 241 139 0 0 0 0 0 0 203 0 256 256 255 255 246 238 150 246 256 256 256 256 245 202 152 0 0 0 0 0 191 192 256 229 0 0 0 0 0 244 256 183 0 0 0 0 0 0 0
0 0 0 0 0 0 230 172 0 0 0 138 250 250 140 0 0 0 0 168 244 248 256 256 255 256 250 225 203 190 176 143 176 189 202 223 249 256 256 256 256 256 208 229 205 186 0 0 158 254 229 0 0 0 0 0 256 241 0 0 0 0 0 0
0 0 0 0 0 250 184 0 0 0 219 251 211 0 0 0 0 224 256 256 256 0 183 0 0 0 0 0 0 0 0 0 0 0 0 0 0 133 0 0 176 239 256 217 159 160 0 0 0 0 226 255 175 0 0 0 136 256 241 0 0 0 0 0
0 0 0 0 145 130 0 0 0 174 0 134 0 0 0 214 256 256 246 158 137 250 203 0 0 0 0 0 0 0 0 0 0 0 0 0 137 0 0 0 0 0 0 152 243 256 249 128 0 0 0 128 151 177 0 0 0 0 0 204 0 0 0 0
0 0 0 194 151 0 0 0 138 231 146 0 0 0 252 256 248 133 0 0 0 0 193 191 150 185 245 256 256 256 256 0 256 256 256 192 223 208 134 0 0 0 0 0 0 0 245 256 195 0 0 0 166 178 0 0 0 0 0 200 191 0 0 0
0 0 188 195 0 0 0 202 218 198 0 0 0 192 0 214 0 0 0 0 0 0 134 0 256 256 256 256 256 256 256 0 256 256 256 192 224 256 256 255 175 0 0 0 0 0 0 205 163 132 0 0 0 211 214 163 0 0 0 162 213 200 0 0
0 0 251 0 0 0 161 240 256 0 0 0 248 218 137 0 0 0 0 0 0 176 256 0 256 256 256 256 256 256 256 0 256 256 256 192 224 256 256 256 256 231 0 0 0 0 0 0 135 240 138 0 0 0 252 241 0 0 0 0 241 256 135 0
0 204 254 0 0 0 251 256 238 0 0 147 256 256 0 0 0 0 0 0 134 240 256 0 256 256 256 256 256 256 256 0 256 256 256 192 224 256 256 256 256 245 209 0 0 0 0 0 0 256 244 0 0 0 252 256 189 0 0 0 212 256 234 0
0 254 210 0 0 0 256 256 256 256 256 166 180 241 0 0 0 0 0 0 164 224 224 233 256 256 256 256 256 256 256 0 256 256 256 244 253 256 256 246 224 224 224 0 0 0 0 0 0 232 228 0 0 0 210 256 249 0 0 0 146 256 256 0
0 208 178 0 0 0 192 234 180 0 0 210 256 256 0 0 0 0 0 0 0 215 256 256 256 256 256 256 256 256 256 0 256 256 256 256 256 256 256 256 256 235 160 0 0 0 0 0 0 253 178 227 242 239 245 226 192 0 0 0 0 251 192 0
0 244 185 0 0 0 256 256 187 0 0 131 256 242 0 0 0 0 0 0 0 145 256 256 256 256 256 256 256 256 256 0 256 256 256 256 256 256 256 256 256 205 0 0 0 0 0 0 0 246 237 0 0 0 237 256 245 0 0 0 0 255 240 0
0 250 231 0 0 0 246 256 244 0 0 0 229 197 0 0 0 0 0 0 0 0 0 197 256 256 256 256 256 256 256 0 256 256 256 256 256 256 256 228 0 0 0 0 0 0 0 0 0 227 0 0 0 0 255 256 178 0 0 0 167 256 256 0
0 188 256 0 0 0 145 240 255 0 0 0 0 207 182 255 143 0 0 0 0 0 0 0 0 0 184 233 256 256 256 0 256 256 256 245 200 143 0 0 0 0 0 0 0 0 133 253 214 0 0 0 0 140 252 241 0 0 0 0 238 256 220 0
0 0 238 149 0 0 0 177 187 199 0 0 0 0 243 256 256 232 0 0 0 0 0 0 0 0 0 0 0 0 0 229 0 0 0 0 0 0 0 0 0 0 0 0 0 227 256 256 168 0 0 0 0 205 181 138 0 0 0 0 227 240 0 0
0 0 176 211 0 0 0 0 157 242 132 0 0 0 0 186 256 256 256 250 179 0 0 0 0 0 0 0 0 0 0 224 0 0 0 0 0 0 0 0 0 0 174 248 256 256 235 0 0 0 0 0 151 246 0 0 0 0 0 195 217 198 0 0
0 0 0 182 139 0 0 0 0 237 152 167 0 0 0 0 0 195 256 256 256 256 256 233 184 143 0 0 0 0 0 250 0 0 0 0 0 141 181 230 256 256 187 205 235 128 0 0 0 0 0 165 171 197 0 0 0 0 0 175 185 0 0 0
0 0 0 0 184 201 0 0 0 0 195 245 238 0 0 0 0 0 0 136 219 256 192 256 256 256 256 256 255 256 208 152 256 256 256 255 256 256 256 256 256 245 134 137 0 0 0 0 0 0 247 254 0 0 0 0 0 194 0 226 0 0 0 0
0 0 0 0 0 234 241 0 0 0 0 0 236 256 188 0 0 0 0 0 0 0 0 149 195 235 256 256 256 241 223 0 242 256 256 256 249 213 170 0 0 0 0 0 0 0 0 0 204 256 205 0 0 0 0 0 215 256 245 0 0 0 0 0
0 0 0 0 0 0 198 255 156 0 0 0 0 0 231 256 187 0 0 0 0 0 0 0 0 0 0 0 0 0 0 0 0 0 0 0 0 0 0 0 0 0 0 170 138 0 202 256 202 0 0 0 0 0 0 249 256 215 0 0 0 0 0 0
0 0 0 0 0 0 0 0 243 159 0 0 0 0 0 0 177 249 235 132 0 0 0 0 0 0 0 0 0 0 0 0 0 0 0 0 0 0 0 0 0 0 0 175 195 234 149 0 0 0 0 0 0 213 253 250 135 0 0 0 0 0 0 0
0 0 0 0 0 0 0 0 0 152 238 232 0 0 0 0 0 0 0 149 197 251 207 155 0 0 0 0 0 0 0 0 0 0 0 0 0 0 0 162 214 245 192 129 0 0 0 0 0 0 0 210 256 254 168 0 0 0 0 0 0 0 0 0
0 0 0 0 0 0 0 0 0 0 0 140 238 251 179 0 0 0 0 0 0 0 0 0 139 171 199 219 220 216 215 156 220 213 217 214 189 162 128 0 0 0 0 0 0 0 0 0 155 241 256 245 154 0 0 0 0 0 0 0 0 0 0 0
0 0 0 0 0 0 0 0 0 0 0 0 0 0 179 249 251 191 0 0 0 0 0 0 0 0 0 0 0 0 0 256 0 0 0 0 0 0 0 0 0 0 0 0 0 174 241 256 253 189 0 0 0 0 0 0 0 0 0 0 0 0 0 0
0 0 0 0 0 0 0 0 0 0 0 0 0 0 0 0 0 151 215 255 253 214 169 129 0 0 0 0 0 0 0 249 0 0 0 0 0 0 0 0 159 202 247 256 256 222 160 0 0 0 0 0 0 0 0 0 0 0 0 0 0 0 0 0
0 0 0 0 0 0 0 0 0 0 0 0 0 0 0 0 0 0 0 0 0 0 161 199 233 256 256 243 235 237 240 222 209 238 231 241 249 256 256 237 204 166 0 0 0 0 0 0 0 0 0 0 0 0 0 0 0 0 0 0 0 0 0 0
0 0 0 0 0 0 0 0 0 0 0 0 0 0 0 0 0 0 0 0 0 0 0 0 0 0 0 0 0 0 0 0 0 0 0 0 0 0 0 0 0 0 0 0 0 0 0 0 0 0 0 0 0 0 0 0 0 0 0 0 0 0 0 0