0 0 0 0 0 0 0 0 0 0 0 0 0 0 0 0 0 0 0 0 0 0 0 0 0 0 0 0 0 0 0 0 0 0 0 0 0 0 0 0 0 0 0 0 0 0 0 0 0 0 0 0 0 0 0 0 0 0 0 0 0 0 0 0
0 30 48 48 48 48 48 48 48 48 48 48 48 48 48 48 48 48 48 48 48 48 48 48 48 48 48 0 0 0 0 0 48 48 48 48 48 48 48 48 48 48 48 48 48 48 48 48 48 48 48 48 48 48 48 48 48 48 48 48 48 48 0 0
0 40 64 64 64 64 64 64 64 64 64 64 64 64 64 64 64 64 64 64 64 64 64 64 64 64 64 0 0 0 0 0 64 64 64 64 64 64 64 64 64 64 64 64 64 64 64 64 64 64 64 64 64 64 64 64 64 64 64 64 64 64 16 0
0 40 64 64 64 64 64 64 64 64 64 64 64 64 64 64 64 64 64 64 64 64 64 64 64 64 64 0 0 0 0 0 64 64 64 64 64 64 64 64 64 64 64 64 64 64 64 64 64 64 64 64 64 64 64 64 64 64 64 64 64 64 16 0
0 40 64 64 40 32 32 32 32 32 32 52 64 64 64 64 64 64 64 64 64 64 64 64 64 64 64 0 0 0 0 0 64 64 64 64 64 60 48 48 62 64 64 64 64 64 64 64 64 64 64 64 64 64 64 64 64 64 64 64 64 64 16 0
0 40 64 64 16 0 0 0 0 0 0 40 64 64 64 64 64 64 64 64 64 64 64 64 64 64 64 0 0 0 0 0 64 64 64 64 64 48 0 0 56 64 64 64 64 56 32 32 32 32 32 32 32 32 32 32 64 64 64 64 64 64 16 0
0 40 64 64 16 0 0 0 0 0 0 40 64 64 64 64 64 64 64 64 64 64 64 64 64 64 64 57 56 56 56 57 64 64 64 64 64 48 0 0 56 64 64 64 64 48 0 0 0 0 0 0 0 0 0 0 64 64 64 64 64 64 16 0
0 40 64 64 16 0 0 25 40 40 40 55 64 64 64 50 0 0 0 0 0 0 57 64 64 64 64 64 64 64 64 64 64 64 64 64 64 48 0 0 56 64 64 64 64 48 0 0 0 0 0 0 0 0 0 0 64 64 64 64 64 64 16 0
0 40 64 64 16 0 0 40 64 64 64 64 64 64 64 48 0 0 0 0 0 0 56 64 64 64 64 64 64 64 64 64 64 64 64 64 64 48 0 0 56 64 64 64 64 56 32 32 32 32 32 32 32 0 0 0 64 64 64 64 64 64 16 0
0 40 64 64 16 0 0 40 64 64 64 64 64 64 64 48 0 0 0 0 0 0 56 64 64 64 64 64 64 64 64 64 64 64 64 64 64 48 0 0 56 64 64 64 64 64 64 64 64 64 64 64 64 24 0 0 64 64 64 64 64 64 16 0
0 40 64 64 16 0 0 40 64 64 64 64 64 64 64 48 0 0 0 0 0 0 56 64 64 64 64 48 48 48 48 48 48 48 48 48 48 36 0 0 56 64 64 64 64 64 64 64 64 64 64 64 64 24 0 0 64 64 64 64 64 64 16 0
0 40 64 64 34 24 24 49 64 64 64 64 64 64 64 48 0 0 0 0 0 0 56 64 64 64 64 0 0 0 0 0 0 0 0 0 0 0 0 0 56 64 64 64 64 64 64 64 64 64 64 64 64 24 0 0 64 64 64 64 64 64 16 0
0 40 64 64 64 64 64 64 64 64 64 64 64 64 64 48 0 0 0 0 0 0 56 64 64 64 64 0 0 0 0 0 0 0 0 0 0 0 0 0 56 64 64 64 64 64 64 64 64 64 64 64 64 24 0 0 64 64 64 64 64 64 16 0
0 40 64 64 64 64 64 64 64 64 64 64 64 64 64 56 32 32 32 32 32 32 60 64 64 64 64 64 64 64 64 64 64 64 64 64 64 48 0 0 56 64 64 64 64 64 64 64 64 64 64 64 64 24 0 0 64 64 64 64 64 64 16 0
0 40 64 64 64 64 64 64 64 64 64 64 64 64 64 64 64 64 64 64 64 64 64 64 64 64 64 64 64 64 64 64 64 64 64 64 64 48 0 0 56 64 64 64 64 64 64 64 64 64 64 64 64 24 0 0 64 64 64 64 64 64 16 0
0 40 64 64 64 64 64 64 64 64 64 64 64 64 64 64 64 64 64 64 64 64 64 64 64 64 64 64 64 64 64 64 64 64 64 64 64 48 0 0 56 64 64 64 64 64 64 64 64 64 64 64 64 24 0 0 64 64 64 64 64 64 16 0
0 40 64 64 64 64 64 64 64 64 64 64 64 64 64 64 64 64 64 64 64 64 64 64 64 64 64 64 64 64 64 64 64 64 64 64 64 48 0 0 0 0 0 0 0 16 64 64 64 64 64 64 64 24 0 0 64 64 64 64 64 64 16 0
0 40 64 64 64 64 64 64 64 64 64 64 64 64 64 64 64 64 56 56 56 64 64 64 64 64 64 64 64 64 64 64 64 64 64 64 64 48 0 0 0 0 0 0 0 16 64 64 64 64 64 64 64 24 0 0 64 64 64 64 64 64 16 0
0 40 64 64 64 64 64 64 64 64 64 64 64 64 64 64 64 64 0 0 0 64 64 64 64 64 64 64 64 64 64 64 64 64 64 64 64 48 0 0 0 0 0 0 0 16 64 64 64 64 64 64 64 24 0 0 64 64 64 64 64 64 16 0
0 40 64 64 64 64 64 64 64 64 64 64 64 64 64 64 64 64 0 0 0 64 64 64 64 64 64 64 64 64 64 64 64 64 64 64 64 48 0 0 56 64 64 64 64 64 64 64 64 64 64 64 64 24 0 0 64 64 64 64 64 64 16 0
0 40 64 64 50 48 48 56 64 64 64 64 64 64 64 64 64 64 0 0 0 64 64 64 64 64 64 64 64 64 64 64 64 64 64 64 64 48 0 0 56 64 64 64 64 64 64 64 64 64 64 64 64 24 0 0 64 64 64 64 64 64 16 0
0 40 64 64 0 0 0 32 64 64 64 64 64 64 64 64 64 64 0 0 0 64 64 64 64 64 64 60 32 32 32 32 32 32 32 32 32 24 0 0 56 64 64 64 64 64 64 64 64 64 64 64 64 24 0 0 64 64 64 64 64 64 16 0
0 40 64 64 0 0 0 32 64 64 64 64 64 64 64 64 64 64 0 0 0 64 64 64 64 64 64 56 0 0 0 0 0 0 0 0 0 0 0 0 56 64 64 64 32 32 32 32 60 64 64 64 64 24 0 0 64 64 64 64 64 64 16 0
0 40 64 64 0 0 0 32 64 64 64 64 64 64 64 64 64 64 0 0 0 64 64 64 64 64 64 58 16 16 16 16 16 16 16 16 16 0 0 0 56 64 64 64 0 0 0 0 56 64 64 64 64 24 0 0 64 64 64 64 64 64 16 0
0 40 64 64 0 0 0 0 16 16 16 16 46 64 64 64 64 64 0 0 0 64 64 64 64 64 64 64 64 64 64 64 64 64 64 64 64 48 0 0 56 64 64 64 0 0 0 0 56 64 64 64 64 24 0 0 64 64 64 64 64 64 16 0
0 40 64 64 0 0 0 0 0 0 0 0 40 64 64 64 64 64 0 0 0 64 64 64 64 64 64 64 64 64 64 64 64 64 64 64 64 48 0 0 56 64 64 64 0 0 0 0 56 64 64 64 64 24 0 0 64 64 64 64 64 64 16 0
0 40 64 64 0 0 0 0 0 0 0 0 40 64 64 64 64 64 0 0 0 64 64 64 64 64 64 64 64 64 64 64 64 64 64 64 64 48 0 0 56 64 64 64 16 16 16 16 58 64 64 64 64 24 0 0 64 64 64 64 64 64 16 0
0 40 64 64 40 40 40 40 40 40 40 40 55 64 64 64 64 64 0 0 0 64 64 64 64 64 64 64 64 64 64 64 64 64 64 64 64 58 40 40 61 64 64 64 64 64 64 64 64 64 64 64 64 29 0 0 64 64 64 64 64 64 16 0
0 40 64 64 64 64 64 64 64 64 64 64 64 64 64 64 64 64 0 0 0 64 64 64 64 64 64 64 64 64 64 64 64 64 64 64 64 64 64 64 64 64 64 64 64 64 64 64 64 64 64 64 64 64 64 64 64 64 64 64 64 64 16 0
0 40 64 64 64 64 64 64 64 64 64 64 64 64 64 64 64 64 0 0 0 64 64 64 64 64 64 64 64 64 64 64 64 64 64 64 64 64 64 64 64 64 64 64 64 64 64 64 64 64 64 64 64 64 64 64 64 64 64 64 64 64 16 0
0 15 24 24 24 24 24 24 24 24 24 24 24 24 24 24 24 24 0 0 0 24 24 24 24 24 24 24 24 24 24 24 24 24 24 24 24 24 24 24 24 24 24 24 24 24 24 24 24 24 24 24 24 24 24 24 24 24 24 24 24 24 0 0
0 0 0 0 0 0 0 0 0 0 0 0 0 0 0 0 0 0 0 0 0 0 0 0 0 0 0 0 0 0 0 0 0 0 0 0 0 0 0 0 0 0 0 0 0 0 0 0 0 0 0 0 0 0 0 0 0 0 0 0 0 0 0 0