0 0 0 0 0 0 0 0 0 0 0 0 0 0 0 0 0 0 0 0 0 0 0 0 0 0 0 0 0 0 0 0 0 0 0 0 0 0 0 0 0 0 0 0 0 0 0 0 0 0 0 0 0 0 0 0 0 0 0 0 0 0 0 0
0 64 156 96 96 96 96 96 96 96 96 96 96 96 96 96 0 0 0 0 0 0 0 0 0 0 0 0 0 0 0 0 0 0 0 64 64 64 64 64 64 64 64 64 64 124 0 0 0 0 0 0 0 0 0 0 0 0 0 0 0 0 0 0
0 64 126 0 0 0 0 0 0 0 0 0 0 0 139 126 0 0 0 0 0 0 0 0 0 0 0 0 0 0 0 0 0 0 0 240 192 192 192 192 192 192 192 192 192 240 0 0 0 0 0 0 0 0 0 0 0 0 0 0 0 132 0 0
0 64 236 224 224 224 224 224 224 224 224 224 224 224 238 236 224 224 224 224 224 224 224 224 224 224 224 224 224 224 224 224 210 0 0 192 0 0 0 0 0 0 0 0 70 248 224 224 224 224 224 224 224 224 224 224 224 224 224 232 144 176 0 0
0 64 166 112 112 112 112 112 112 112 148 175 112 112 112 112 202 256 121 112 112 112 112 112 112 148 193 112 112 211 148 184 141 0 0 192 0 0 0 0 0 0 0 0 0 0 0 0 0 0 0 0 0 0 0 0 0 0 0 64 151 181 0 0
0 64 96 0 0 0 0 0 0 0 64 112 0 0 64 64 184 256 0 0 52 0 0 0 0 64 144 0 0 176 64 128 64 0 0 192 0 244 224 224 224 224 224 224 224 224 224 224 224 224 224 224 224 224 224 224 112 0 144 64 214 226 0 0
0 64 196 160 160 162 173 160 160 160 180 165 0 128 256 256 256 256 0 96 208 0 0 0 0 64 144 0 0 176 64 128 64 0 0 192 0 172 0 0 0 0 0 116 214 0 0 0 60 0 0 0 0 158 256 0 0 0 144 64 144 176 0 0
0 64 96 0 0 0 208 0 0 0 0 0 0 0 158 0 172 256 0 96 208 0 0 98 0 52 159 96 156 176 64 128 64 0 0 192 0 160 0 0 126 0 0 96 229 112 112 112 238 0 0 0 0 144 256 0 56 96 144 64 144 176 0 0
0 64 96 96 96 116 226 96 96 96 96 96 78 0 144 0 160 256 166 196 238 160 0 224 144 128 128 128 136 176 64 128 64 192 0 192 0 160 0 0 238 224 224 236 229 112 112 112 238 0 0 0 0 144 256 0 112 144 144 64 144 176 0 0
0 64 96 160 160 172 235 144 144 179 228 151 208 0 135 0 160 256 106 96 156 186 0 224 116 96 196 106 134 176 64 128 64 192 0 192 0 160 0 0 224 0 0 96 208 0 0 0 224 0 0 0 0 144 256 0 112 144 144 64 144 176 0 0
0 64 96 0 0 0 208 0 0 80 192 0 208 0 0 0 160 256 0 0 96 144 0 224 0 0 160 0 128 176 64 128 64 192 0 192 0 160 0 91 238 112 112 166 208 0 0 0 230 87 0 0 0 165 256 0 112 144 144 64 144 176 0 0
0 71 106 0 122 0 208 0 54 80 192 0 241 176 176 176 226 256 0 0 96 144 0 224 0 0 160 0 200 221 64 128 64 192 0 192 0 160 0 188 248 242 234 236 208 0 0 100 166 256 166 160 160 214 256 0 112 200 200 112 144 176 0 0
0 132 192 232 184 0 208 64 144 80 192 0 0 0 0 0 138 216 0 0 96 235 208 250 0 0 160 0 160 226 64 128 64 192 0 192 0 160 0 0 192 144 80 96 229 112 112 112 121 256 0 0 0 144 256 0 112 136 184 100 144 176 0 0
0 0 0 160 160 0 208 64 144 80 192 0 0 0 0 0 0 128 0 0 0 54 0 224 0 0 160 0 0 176 64 128 64 192 0 0 0 160 0 0 192 144 80 96 241 176 176 176 181 256 0 0 0 144 256 160 202 96 160 80 144 176 0 0
0 0 112 160 160 0 238 184 144 80 192 0 0 0 0 0 0 200 144 144 144 126 0 224 0 200 202 0 0 176 64 128 64 192 0 0 0 160 0 0 192 144 80 0 0 0 0 0 0 256 0 0 0 72 128 0 112 96 160 80 144 176 0 0
0 0 200 160 160 0 217 100 144 80 192 0 0 0 0 0 0 128 151 0 76 149 0 224 0 216 208 0 0 176 64 128 208 240 204 192 200 232 157 139 192 144 80 0 0 0 0 0 0 256 0 0 0 0 0 0 112 96 160 80 144 176 0 0
0 0 128 160 160 0 208 64 144 80 212 80 80 80 80 80 80 80 179 0 64 144 0 224 0 176 160 0 0 176 64 120 120 80 80 212 80 80 0 0 192 144 80 0 0 0 0 0 0 256 80 256 256 256 256 80 112 96 160 80 144 176 0 0
0 0 128 160 160 0 208 64 144 80 240 192 192 192 216 200 192 192 192 0 64 144 0 224 0 176 160 0 0 176 64 0 0 0 0 192 0 0 0 0 192 144 179 144 144 144 144 0 200 256 80 214 0 0 130 0 112 96 80 72 144 176 0 0
0 0 128 160 160 0 208 64 144 0 0 0 0 0 96 0 0 0 0 0 64 144 0 224 0 176 160 0 0 176 64 0 0 176 176 192 0 0 0 0 0 144 157 112 139 256 121 0 112 0 64 208 0 172 235 208 229 96 0 64 144 176 0 0
0 0 128 160 160 0 208 64 256 256 256 256 256 256 256 256 256 256 160 0 64 144 0 224 0 176 160 0 0 176 64 0 0 0 0 84 0 0 0 0 0 81 0 0 0 256 0 0 112 0 64 208 0 0 208 0 112 106 0 76 151 181 0 0
0 98 208 160 160 0 208 64 144 0 0 60 0 0 0 0 0 0 0 0 64 144 0 224 0 176 160 0 0 176 244 240 240 240 240 240 248 242 0 190 248 224 224 224 230 256 0 0 112 0 64 208 0 0 208 0 112 236 224 224 238 232 110 0
0 56 112 160 160 0 208 64 221 176 176 236 144 0 0 0 0 0 0 0 64 144 0 224 0 176 160 196 192 236 64 0 0 0 0 0 128 60 0 88 200 0 0 0 0 256 211 208 215 195 64 208 0 0 208 0 112 96 0 0 112 64 96 0
0 0 0 0 160 0 208 64 144 0 112 224 200 128 128 128 128 128 128 128 160 144 0 224 0 176 160 0 0 55 0 0 0 0 0 0 128 228 224 224 224 224 56 0 0 240 0 0 0 0 64 226 96 126 208 0 112 96 0 0 112 64 96 0
0 90 160 160 188 60 208 64 144 0 98 112 112 112 112 130 202 112 112 112 148 144 0 224 214 215 160 0 0 0 0 0 96 0 0 0 0 0 0 0 0 0 0 0 0 0 0 0 0 0 64 214 0 62 156 0 112 96 0 0 112 64 96 0
0 0 0 0 184 116 208 64 144 0 0 0 0 0 0 0 160 0 0 0 0 0 0 224 87 120 160 0 0 0 0 64 256 201 176 176 176 176 176 176 176 176 176 176 176 176 176 176 176 176 196 241 176 110 0 0 112 96 0 0 112 64 96 0
0 0 110 160 180 0 0 64 144 0 0 120 0 0 0 0 0 0 0 0 0 0 0 224 0 96 160 0 0 0 0 64 256 113 0 0 0 113 178 0 0 0 0 0 0 0 100 204 0 0 0 0 0 0 0 0 112 96 0 0 112 208 96 0
0 0 0 211 162 0 0 237 243 224 224 254 226 224 224 224 232 237 224 224 224 224 224 252 0 96 160 106 96 96 96 136 256 146 0 0 0 98 178 0 126 240 0 0 0 0 64 192 0 0 0 0 0 0 0 0 112 96 0 0 112 64 96 0
0 0 0 208 160 0 0 144 160 0 0 240 0 0 0 0 128 208 0 0 0 0 0 98 0 96 160 256 256 256 256 256 256 256 128 0 0 88 128 128 176 240 0 0 0 0 64 252 240 240 240 240 240 240 240 240 247 246 0 0 112 0 0 0
0 0 0 130 160 0 0 126 140 0 0 240 0 0 0 0 128 208 0 0 0 0 0 0 0 96 90 0 0 0 0 0 0 0 0 0 0 0 0 0 96 240 0 0 0 0 64 208 64 64 76 196 166 160 160 160 160 160 108 96 166 0 0 0
0 0 208 208 238 208 208 208 208 208 208 253 211 0 176 256 256 256 256 256 256 256 256 256 172 166 72 192 192 192 192 192 192 192 192 192 192 192 192 192 216 252 192 192 192 192 208 192 0 0 0 0 0 0 0 0 0 0 0 0 72 0 0 0
0 0 96 96 96 96 96 96 96 96 96 96 96 0 55 80 80 80 80 80 80 80 80 80 0 0 0 0 0 0 0 0 0 0 0 0 0 0 0 0 0 0 0 0 0 0 60 108 0 0 0 0 0 0 0 0 0 0 0 0 0 0 0 0
0 0 0 0 0 0 0 0 0 0 0 0 0 0 0 0 0 0 0 0 0 0 0 0 0 0 0 0 0 0 0 0 0 0 0 0 0 0 0 0 0 0 0 0 0 0 0 0 0 0 0 0 0 0 0 0 0 0 0 0 0 0 0 0