0 96 96 96 96 96 96 96 96 96 96 96 96 54 0 0 96 96 96 96 96 96 96 96 96 96 96 96 96 96 96 0
80 256 256 256 256 256 256 256 256 256 256 256 256 144 0 0 256 256 256 256 256 256 256 256 256 256 256 256 256 256 256 0
80 256 88 64 64 124 256 256 256 256 256 256 256 144 0 0 256 256 236 96 246 256 248 192 192 192 192 192 256 256 256 0
80 256 0 0 80 135 256 242 144 144 144 249 256 249 240 241 256 256 224 0 240 256 224 0 0 0 0 0 256 256 256 0
80 256 0 80 256 256 256 224 0 0 0 240 256 256 256 256 256 256 224 0 240 256 248 192 192 192 132 0 256 256 256 0
80 256 74 113 256 256 256 224 0 0 0 240 256 176 96 96 96 96 84 0 240 256 256 256 256 256 176 0 256 256 256 0
80 256 256 256 256 256 256 232 64 64 64 244 256 192 128 128 128 128 112 0 240 256 256 256 256 256 176 0 256 256 256 0
80 256 256 256 256 256 256 256 256 256 256 256 256 256 256 256 256 256 224 0 240 256 256 256 256 256 176 0 256 256 256 0
80 256 256 256 256 256 256 256 256 240 248 256 256 256 256 256 256 256 224 0 0 0 0 256 256 256 176 0 256 256 256 0
80 256 256 256 256 256 256 256 256 0 128 256 256 256 256 256 256 256 224 0 120 128 144 256 256 256 176 0 256 256 256 0
80 256 106 136 256 256 256 256 256 0 128 256 256 252 192 192 192 192 168 0 240 256 256 256 256 256 176 0 256 256 256 0
80 256 0 64 256 256 256 256 256 0 128 256 256 242 0 0 0 0 0 0 240 256 64 64 244 256 176 0 256 256 256 0
80 256 0 0 0 0 214 256 256 0 128 256 256 256 256 256 256 256 224 0 240 256 0 0 240 256 176 0 256 256 256 0
80 256 80 80 80 80 223 256 256 0 128 256 256 256 256 256 256 256 234 80 245 256 160 160 250 256 181 0 256 256 256 0
80 256 256 256 256 256 256 256 256 0 128 256 256 256 256 256 256 256 256 256 256 256 256 256 256 256 256 256 256 256 256 0
0 0 0 0 0 0 0 0 0 0 0 0 0 0 0 0 0 0 0 0 0 0 0 0 0 0 0 0 0 0 0 0