160 192 192 63 0 0 0 124 192 123 53 192 192 192 192 192 192 192 192 192 192 192 192 192 192 192 192 192 192 192 192 144
208 237 256 105 197 207 76 0 177 234 55 256 256 255 205 158 139 128 143 155 178 210 252 256 256 256 102 175 95 180 256 192
208 148 256 121 237 256 250 0 67 256 94 256 256 123 0 176 208 208 187 107 0 0 0 217 256 256 237 107 0 98 244 192
208 133 256 128 223 256 256 133 165 256 96 256 256 191 0 252 256 256 256 256 232 56 0 118 254 211 236 256 235 138 0 0
208 81 256 109 179 256 195 242 256 256 109 256 256 256 57 211 256 256 256 256 256 135 0 203 139 0 0 167 256 256 256 162
208 0 203 72 111 256 122 143 256 256 150 256 256 256 181 132 206 157 208 145 98 172 254 256 146 0 0 0 235 256 256 192
208 0 0 0 0 256 225 0 215 256 256 256 256 256 255 79 254 128 89 199 256 256 256 256 226 0 0 0 147 256 256 192
208 168 0 0 0 256 256 76 80 256 256 256 256 256 256 162 173 256 256 256 256 256 256 256 256 88 0 0 83 256 256 192
208 256 256 233 241 256 256 138 0 225 256 256 256 247 256 250 73 255 256 256 256 256 256 256 256 214 0 0 0 256 256 192
208 256 256 256 256 256 256 115 0 86 253 256 256 60 54 223 115 172 256 256 256 256 256 256 256 256 95 0 0 255 256 192
208 256 256 256 238 179 103 0 0 0 77 256 256 124 0 0 64 0 251 256 256 149 153 244 256 256 222 0 0 236 256 192
208 254 175 68 0 0 53 98 144 195 248 256 256 244 0 0 0 0 153 256 256 124 101 67 140 246 256 76 0 219 256 192
208 162 135 178 222 254 256 256 256 256 256 251 186 248 241 111 0 0 133 256 177 144 231 256 140 0 96 0 0 204 256 192
208 256 256 256 256 256 256 256 256 256 256 174 0 82 220 148 168 248 256 256 254 197 111 64 0 0 0 0 0 185 256 192
208 256 256 256 256 256 256 256 256 191 62 104 226 256 218 255 140 0 232 256 256 256 256 255 209 154 74 0 0 147 256 192
175 208 208 208 208 208 208 207 96 56 178 208 208 208 192 156 104 101 207 208 208 208 208 208 208 208 208 203 166 188 208 160