0 0 0 0 0 0 0 0 0 0 0 0 0 0 0 0 0 0 0 0 0 0 0 0 0 0 0 0 0 0 0 0 0 0 0 0 0 0 0 0 0 0 0 0 0 0 0 0 0 0 0 0 0 0 0 0 0 0 0 0 0 0 0 0
0 0 0 0 182 165 0 138 160 0 0 0 0 0 0 0 0 0 0 0 0 0 0 0 0 0 0 0 0 0 0 149 192 189 159 0 0 0 0 0 0 0 0 198 208 208 208 208 208 208 208 208 151 0 0 0 0 0 0 0 0 0 0 0
0 0 186 234 0 0 0 168 256 165 0 132 158 160 181 192 189 173 0 0 0 0 0 0 139 188 225 246 256 252 200 0 0 0 143 162 192 253 253 184 0 128 0 0 0 0 0 0 0 0 0 0 0 128 152 247 256 231 0 0 0 0 0 0
0 0 224 0 0 243 256 256 249 256 256 256 256 256 256 256 256 256 256 240 128 0 236 256 256 256 223 179 0 0 0 0 171 248 0 0 160 0 0 240 235 224 0 0 208 208 208 208 208 208 208 168 0 179 240 186 0 209 256 231 0 0 0 0
0 0 256 0 170 256 256 194 0 256 219 153 0 0 0 0 0 0 173 256 256 256 256 216 141 0 0 0 0 0 168 238 256 256 137 224 206 0 206 240 223 205 0 219 256 256 256 256 256 256 256 219 0 0 176 249 0 0 166 160 0 0 0 0
0 0 256 0 176 256 185 0 0 0 0 0 0 0 151 176 168 138 174 256 256 256 250 0 0 157 240 256 247 0 0 256 256 256 254 256 149 0 256 245 208 0 0 256 256 256 256 256 256 256 250 208 209 0 132 250 202 0 206 256 226 0 0 0
0 0 256 0 176 256 211 173 0 0 0 197 256 256 256 256 256 256 256 256 256 256 256 250 256 256 256 256 256 182 0 245 256 250 240 240 0 128 256 256 256 0 199 240 249 256 256 256 256 256 256 256 256 248 253 256 256 0 128 256 253 0 0 0
0 0 256 0 176 253 192 0 0 171 0 0 216 208 228 256 256 256 256 256 256 256 256 256 256 256 256 247 224 222 0 143 224 228 224 204 0 205 256 256 256 256 256 256 256 256 246 200 256 256 256 256 256 256 256 256 241 0 0 256 256 0 0 0
0 0 247 185 237 256 218 0 146 207 213 0 0 144 151 253 256 256 256 256 256 256 256 256 256 256 256 256 256 256 0 0 256 256 256 165 0 256 256 256 256 256 256 256 241 150 0 0 256 256 256 256 256 256 213 0 0 0 0 256 256 0 0 0
0 0 144 256 251 208 0 0 194 197 208 0 0 235 246 256 256 256 256 241 224 224 219 194 192 192 165 243 256 256 251 247 256 256 256 136 0 256 256 256 256 238 154 0 0 0 151 248 256 192 141 0 0 0 0 0 172 191 0 256 256 0 0 0
0 0 0 247 256 256 0 158 208 239 256 0 0 128 256 219 0 0 0 0 0 0 0 0 0 0 0 223 256 256 256 256 256 256 256 153 0 128 128 0 0 0 0 136 215 256 256 256 256 0 0 0 140 162 239 256 256 192 0 256 256 0 0 0
0 0 0 208 256 256 0 192 256 256 251 0 0 0 0 0 0 157 209 231 254 256 256 256 256 249 256 256 256 256 256 256 256 256 256 185 0 0 0 0 0 142 0 256 255 256 256 256 256 256 128 0 256 256 256 256 256 192 0 256 256 0 0 0
0 0 0 208 256 256 0 192 256 256 226 0 248 0 0 214 256 256 256 256 195 173 159 256 163 0 232 256 250 256 256 256 256 256 256 217 0 256 256 256 256 244 0 198 240 249 256 256 256 256 0 0 256 256 256 256 256 192 0 256 256 0 0 0
0 0 0 203 256 256 0 198 256 256 224 0 256 136 0 200 192 226 256 256 0 0 208 193 0 173 256 0 208 256 256 256 256 256 256 163 0 249 256 256 256 256 0 192 256 256 256 256 256 256 0 131 256 256 256 256 256 192 0 256 256 0 0 0
0 0 0 0 256 256 240 256 256 256 224 0 256 217 0 149 224 224 180 128 0 0 0 0 0 234 210 0 128 155 223 256 256 200 0 0 0 178 224 235 240 218 0 209 256 256 246 224 224 217 0 168 208 208 236 256 256 183 0 256 256 0 0 0
0 0 0 0 256 256 256 256 256 256 224 0 256 157 130 217 256 256 222 0 0 0 0 0 0 240 249 256 149 0 0 0 0 0 0 213 0 191 256 256 256 129 0 180 176 176 224 224 224 159 0 255 256 256 227 224 224 0 0 224 224 0 0 0
0 0 0 152 256 256 256 256 256 256 224 0 256 229 167 256 256 256 256 255 153 0 234 0 0 256 256 256 256 256 233 192 191 233 256 256 0 192 256 256 256 248 248 256 256 256 235 208 189 0 136 224 224 228 240 240 239 0 155 224 210 0 0 0
0 0 0 250 256 256 256 256 256 256 218 0 256 256 226 201 256 256 256 256 256 241 255 144 0 256 256 256 256 256 256 256 256 256 256 256 0 192 256 256 256 256 256 256 256 256 240 249 0 0 235 256 256 256 256 256 205 0 248 256 200 0 0 0
0 0 152 256 256 256 256 256 256 256 208 0 256 256 0 128 203 130 128 150 229 176 240 144 0 256 256 256 256 256 256 256 256 237 224 203 0 228 256 256 256 256 256 256 256 256 198 0 0 0 0 195 256 256 256 256 0 0 240 244 247 0 0 0
0 0 250 174 0 256 256 256 256 256 226 0 247 240 0 0 0 0 0 0 0 0 192 144 0 256 256 241 251 256 256 256 256 256 256 0 0 194 192 201 249 256 256 256 256 249 0 0 245 255 140 142 256 256 256 248 0 170 256 256 256 144 0 0
0 0 256 132 0 256 256 256 256 256 256 218 256 256 256 0 140 234 256 239 165 0 217 144 0 256 256 0 0 134 233 256 256 252 240 0 152 240 240 256 256 256 256 256 256 256 248 256 256 256 256 256 250 193 192 0 0 0 198 247 171 247 0 0
0 0 256 128 0 256 256 256 256 256 256 256 256 256 256 0 230 247 256 254 252 0 152 197 153 256 256 251 173 0 0 0 183 255 167 0 222 240 250 256 250 154 256 256 256 256 256 256 256 256 256 255 215 208 195 0 205 256 256 208 0 256 0 0
0 0 256 128 0 256 256 256 256 252 225 256 256 256 256 256 256 256 256 256 256 0 144 256 256 256 256 256 256 255 217 0 0 0 0 0 240 240 252 256 207 0 251 256 256 256 256 256 256 256 256 229 176 175 0 0 176 200 256 208 0 256 0 0
0 0 256 150 0 243 256 256 176 0 0 160 160 160 256 256 256 256 252 240 240 0 161 256 256 247 181 256 256 255 256 256 181 0 0 182 256 256 256 256 151 0 0 224 224 236 256 256 244 179 160 160 160 0 0 201 208 240 256 208 0 256 0 0
0 0 0 136 0 156 216 0 0 141 217 0 0 0 256 256 256 256 256 240 183 0 228 256 256 0 0 256 256 256 240 0 0 129 253 256 256 172 144 147 0 0 0 229 256 256 256 256 249 192 192 192 171 0 0 160 162 250 256 208 0 256 0 0
0 0 134 240 146 0 0 0 226 256 224 0 0 0 256 256 256 256 256 238 0 0 256 256 198 0 0 256 236 158 0 0 215 256 256 256 141 0 0 0 0 230 0 129 247 256 256 256 256 256 256 256 0 0 227 224 228 256 256 243 0 222 0 0
0 0 0 0 0 0 0 239 256 256 252 253 256 256 256 256 256 187 0 0 0 235 256 241 0 0 0 0 0 0 158 255 256 256 256 256 0 176 204 0 161 241 177 0 156 176 191 243 256 183 144 0 0 164 208 238 256 256 256 256 0 208 0 0
0 0 0 0 0 0 0 0 186 256 256 256 256 256 256 256 256 0 0 198 256 256 256 0 0 0 0 138 218 256 256 256 256 256 256 256 151 0 0 0 141 256 256 150 0 0 0 185 256 213 218 0 0 192 210 252 256 256 256 256 0 208 0 0
0 0 0 0 0 0 248 138 0 0 131 227 256 256 0 168 254 256 256 256 256 184 0 0 0 0 0 256 240 256 241 168 0 136 256 256 159 0 173 0 0 256 256 256 256 128 0 256 256 239 0 0 202 208 250 256 167 144 144 144 0 169 0 0
0 0 0 0 0 0 176 246 238 163 0 0 256 215 0 0 0 148 139 0 0 0 0 0 0 0 0 129 0 0 0 0 0 0 167 254 0 171 256 156 139 250 138 139 250 152 0 256 252 0 0 133 0 0 176 255 0 0 0 0 0 0 0 0
0 0 0 0 0 0 0 0 0 0 168 188 0 0 0 0 0 0 0 0 0 0 0 0 0 0 0 0 0 0 0 0 0 0 0 0 146 0 0 134 145 0 0 0 0 149 161 0 185 0 0 0 0 0 0 0 150 160 160 160 158 0 0 0
0 0 0 0 0 0 0 0 0 0 0 0 0 0 0 0 0 0 0 0 0 0 0 0 0 0 0 0 0 0 0 0 0 0 0 0 0 0 0 0 0 0 0 0 0 0 0 0 0 0 0 0 0 0 0 0 0 0 0 0 0 0 0 0