24 32 32 32 32 32 19 0 0 0 0 0 0 0 21 32 32 32 32 0 0 20 32 32 32 32 32 32 32 32 32 32 32 32 32 32 32 32 32 32 32 32 32 32 32 32 32 32 32 32 32 32 32 32 32 32 32 32 32 32 32 32 32 16
40 64 64 64 64 64 44 0 0 0 0 0 0 0 0 61 64 64 64 25 0 33 64 64 64 64 64 64 64 64 64 64 64 64 64 64 64 64 64 64 64 64 64 64 64 64 64 64 64 64 64 64 64 64 64 64 64 64 64 64 64 64 64 32
40 64 64 64 64 64 49 0 26 56 49 30 0 0 0 14 57 64 64 45 0 29 64 64 64 64 64 64 64 64 64 64 64 64 64 64 64 64 64 64 64 64 64 64 64 64 64 64 64 64 64 64 29 50 64 64 62 27 42 64 64 64 64 32
40 64 46 45 64 64 56 0 40 64 64 64 57 15 0 0 0 52 64 61 0 24 64 64 64 64 64 63 47 30 19 0 0 0 0 0 0 0 0 16 22 28 36 46 60 64 64 64 64 64 64 64 37 0 15 32 17 0 18 64 64 64 64 32
40 64 20 24 64 64 57 0 32 64 64 64 64 58 0 0 0 30 64 64 0 24 64 64 64 64 59 0 0 0 0 0 0 0 0 0 0 0 0 0 0 0 0 0 0 17 56 64 64 64 64 64 64 45 0 0 0 0 0 64 64 64 64 32
40 64 16 24 64 64 64 0 32 64 64 64 64 64 35 0 0 37 64 64 0 20 64 64 64 64 53 0 0 0 52 64 64 64 64 64 64 64 62 42 0 0 0 0 0 0 33 64 64 64 64 64 64 64 62 36 0 0 0 19 44 60 64 32
40 64 16 24 64 64 64 0 32 64 64 64 64 64 58 0 0 59 64 64 0 16 64 64 64 64 64 16 0 0 64 64 64 64 64 64 64 64 64 64 64 40 0 0 0 0 21 64 64 64 64 64 64 64 64 64 63 44 18 0 0 0 0 0
40 64 16 24 64 64 64 0 32 64 64 64 64 64 64 0 38 64 64 64 0 16 64 64 64 64 64 47 0 0 60 64 64 64 64 64 64 64 64 64 64 64 51 0 0 0 0 33 64 62 43 40 46 62 64 64 64 64 64 56 32 0 0 0
40 64 16 24 64 64 56 0 30 64 64 64 64 64 64 50 64 64 64 64 0 24 64 64 64 64 64 64 13 0 50 64 64 64 64 64 64 64 64 64 64 64 53 0 0 0 17 58 64 14 0 0 0 0 49 64 64 64 64 64 64 64 49 17
40 64 16 15 64 64 53 0 17 64 64 64 36 31 64 64 64 64 64 64 0 24 64 64 64 64 64 64 44 0 33 64 64 64 64 64 64 64 64 62 41 19 0 0 0 40 64 64 61 0 0 0 0 0 0 51 64 64 64 64 64 64 64 32
40 64 16 0 53 64 44 0 0 62 64 64 49 0 33 64 64 64 64 64 0 32 64 64 64 64 64 64 64 0 14 64 64 34 60 64 64 56 23 0 0 0 0 36 62 64 64 64 64 0 0 0 0 0 0 0 63 64 64 64 64 64 64 32
40 64 16 0 22 64 28 0 0 47 64 64 64 0 0 46 64 64 64 64 49 59 64 64 64 64 64 64 64 41 0 54 64 44 0 28 16 0 0 0 14 43 63 64 64 64 64 64 64 16 0 0 0 0 0 0 44 64 64 64 64 64 64 32
40 64 16 0 0 23 0 0 0 30 64 64 64 36 0 0 60 64 64 64 64 64 64 64 64 64 64 64 64 63 0 29 64 64 23 0 0 0 21 50 64 64 64 64 64 64 64 64 64 38 0 0 0 0 0 0 20 64 64 64 64 64 64 32
40 64 16 0 0 0 0 0 0 19 64 64 64 61 0 0 27 64 64 64 64 64 64 64 64 64 64 64 64 64 37 0 62 64 64 41 33 55 64 64 64 64 64 64 64 64 64 64 64 60 0 0 0 0 0 0 0 61 64 64 64 64 64 32
40 64 40 0 0 0 0 0 0 0 64 64 64 64 27 0 0 55 64 64 64 64 64 64 64 64 64 64 64 64 62 0 37 64 64 64 64 64 64 64 64 64 64 64 64 64 64 64 64 64 28 0 0 0 0 0 0 48 64 64 64 64 64 32
40 64 64 60 34 0 0 0 0 22 64 64 64 64 49 0 0 24 64 64 64 64 64 64 64 64 64 64 64 64 64 31 0 63 64 64 64 64 64 64 64 64 64 64 64 64 64 64 64 64 58 0 0 0 0 0 0 35 64 64 64 64 64 32
40 64 64 64 64 64 57 48 50 63 64 64 64 64 63 0 0 0 59 64 64 64 64 64 64 64 64 64 64 64 64 58 0 40 64 64 64 64 64 64 64 64 64 64 64 64 64 64 64 64 64 28 0 0 0 0 0 22 64 64 64 64 64 32
40 64 64 64 64 64 64 64 64 64 64 64 64 64 64 0 0 0 38 64 64 64 64 64 64 64 63 56 64 64 64 64 22 0 63 64 64 64 64 64 64 64 64 64 64 64 64 64 64 64 64 58 0 0 0 0 0 13 64 64 64 64 64 32
40 64 64 64 64 64 64 64 64 64 64 64 64 64 64 0 0 0 0 61 64 64 64 64 64 64 32 0 0 45 64 64 48 0 39 64 64 64 64 64 64 64 64 64 64 64 64 64 64 64 64 64 31 0 0 0 0 0 64 64 64 64 64 32
40 64 64 64 64 64 64 64 64 64 64 64 64 64 45 0 0 0 0 17 61 64 64 64 64 64 28 0 0 0 32 63 63 0 0 62 64 64 64 64 64 64 64 64 64 64 64 64 64 64 64 64 60 0 0 0 0 0 63 64 64 64 64 32
40 64 64 64 64 64 64 64 64 64 64 64 62 38 0 0 0 0 0 0 0 52 64 64 64 64 47 0 0 0 0 16 52 0 0 34 64 64 64 64 64 64 63 56 62 64 64 64 64 64 64 64 64 34 0 0 0 0 56 64 64 64 64 32
40 64 64 64 64 64 64 64 62 48 33 18 0 0 0 0 0 0 0 0 0 15 64 64 64 64 64 13 0 0 0 0 0 0 0 0 59 64 64 64 64 64 30 0 0 24 52 64 64 64 64 64 64 60 0 0 0 0 52 64 64 64 64 32
40 64 64 64 64 64 46 22 0 0 0 0 0 0 0 0 0 13 27 40 56 64 64 64 64 64 64 52 0 0 0 0 0 0 0 0 28 64 64 64 64 64 23 0 0 0 0 20 52 64 64 64 64 64 28 0 0 0 48 64 64 64 64 32
40 64 64 62 37 0 0 0 0 0 0 0 21 32 44 54 64 64 64 64 64 64 64 64 64 64 64 64 43 0 0 0 0 0 0 0 0 59 64 64 64 64 61 56 56 49 26 0 0 24 54 64 64 64 48 0 0 0 43 64 64 64 64 32
40 64 49 0 0 0 20 30 42 52 62 64 64 64 64 64 64 64 64 64 64 64 64 64 64 64 64 64 64 49 0 0 0 0 0 0 0 49 64 64 64 49 59 64 64 64 64 55 28 0 0 19 41 55 40 0 0 0 40 64 64 64 64 32
40 64 54 51 61 64 64 64 64 64 64 64 64 64 64 64 64 64 64 64 64 64 64 59 26 32 56 64 64 64 62 40 17 0 0 0 21 63 64 64 62 0 0 19 41 60 64 64 64 14 0 0 0 0 0 0 0 0 36 64 64 64 64 32
40 64 64 64 64 64 64 64 64 64 64 64 64 64 64 64 64 64 64 64 64 64 64 52 0 0 0 34 64 64 64 45 63 64 60 64 64 64 64 64 64 60 44 18 0 0 14 24 0 0 0 0 0 0 0 0 0 0 32 64 64 64 64 32
40 64 64 64 64 64 64 64 64 64 64 64 64 64 64 64 64 64 64 64 64 64 46 0 0 0 0 0 28 64 64 0 0 35 60 64 64 64 64 64 64 64 64 64 61 42 20 0 0 0 0 0 0 0 0 0 0 0 25 64 64 64 64 32
40 64 64 64 64 64 64 64 64 64 64 64 64 64 64 64 64 64 64 64 41 15 0 0 36 62 62 26 0 50 64 56 23 0 0 33 63 64 64 64 64 64 64 64 64 64 64 63 48 31 0 0 0 0 0 0 0 0 16 64 64 64 64 32
40 64 64 64 64 64 64 64 64 64 64 64 64 64 64 64 64 64 48 15 0 0 36 62 64 64 64 64 56 64 64 64 64 48 0 0 37 64 64 64 64 64 64 64 64 64 64 64 64 64 64 55 34 21 16 16 16 16 19 64 64 64 64 32
40 64 64 64 64 64 64 64 64 64 64 64 64 64 64 64 52 25 0 0 36 62 64 64 64 64 64 64 64 64 64 63 51 28 0 0 32 64 64 64 64 64 64 64 64 64 64 64 64 64 64 64 64 64 64 64 64 64 64 64 64 64 64 32
31 40 40 40 40 40 40 40 40 40 40 40 40 40 40 39 0 0 0 38 40 40 40 40 40 40 40 40 36 28 19 0 0 0 0 14 24 40 40 40 40 40 40 40 40 40 40 40 40 40 40 40 40 40 40 40 40 40 40 40 40 40 40 24