0 0 0 0 0 0 0 0 0 0 0 0 0 0 0 0 0 0 16 16 16 16 16 16 16 16 16 16 16 16 16 16 16 16 16 16 16 16 16 16 16 16 16 16 16 16 16 14 0 0 0 0 0 0 0 0 0 0 0 0 0 0 0 0
0 0 0 0 0 0 0 0 0 0 0 0 0 0 0 0 0 40 64 64 64 64 64 64 64 64 64 64 64 64 64 64 64 64 64 64 64 64 64 64 64 64 64 64 64 64 64 56 0 0 0 0 0 0 0 0 0 0 0 0 0 0 0 0
0 0 0 0 0 0 0 0 0 0 0 0 0 0 0 0 0 40 64 29 24 24 24 24 24 24 24 24 24 24 24 24 24 24 24 24 24 24 24 24 24 24 24 24 24 24 64 56 0 0 0 0 0 0 0 0 0 0 0 0 0 0 0 0
0 0 0 0 0 0 0 0 0 0 0 0 0 0 0 0 0 40 64 0 0 0 0 0 0 0 0 0 0 0 0 0 0 21 59 47 0 0 0 0 0 0 0 0 0 0 64 56 0 0 0 0 0 0 0 0 0 0 0 0 0 0 0 0
0 0 0 48 48 48 48 48 48 48 48 48 48 48 48 48 48 58 64 50 48 48 48 48 48 36 0 0 0 0 0 0 0 63 64 64 45 0 0 0 0 0 0 0 56 64 64 64 64 64 64 64 64 64 64 64 64 64 64 64 64 40 0 0
0 0 16 64 64 64 64 64 64 64 64 64 64 64 64 64 64 64 64 64 64 64 64 64 64 48 0 0 0 0 0 0 43 64 64 64 64 14 0 0 0 0 0 0 56 64 64 64 64 64 64 64 64 64 64 64 64 64 64 64 64 40 0 0
0 0 16 64 64 64 64 64 64 64 64 64 64 64 64 64 64 64 64 64 64 64 64 64 64 48 0 0 0 0 0 0 62 64 64 64 64 48 32 32 32 32 32 32 60 64 64 64 64 64 64 64 64 64 64 64 64 64 64 64 64 40 0 0
0 0 16 64 64 64 64 64 64 64 64 64 64 64 64 64 64 64 64 64 64 64 64 64 64 48 0 0 0 0 0 17 64 64 64 64 64 64 64 64 64 64 64 64 64 64 64 64 64 64 64 64 64 64 64 64 64 64 64 64 64 40 0 0
0 0 16 64 64 64 64 64 64 64 64 64 64 64 64 64 64 64 64 64 64 64 64 64 64 48 0 0 0 0 0 29 64 64 64 64 64 64 17 16 16 16 16 16 58 64 64 64 64 64 64 64 64 64 64 64 64 64 64 64 64 40 0 0
0 0 16 64 64 64 64 64 64 64 64 64 64 64 64 64 64 64 64 64 64 64 64 64 64 48 0 0 0 0 0 37 64 64 64 64 64 64 0 0 0 0 0 0 56 64 64 64 64 64 64 64 64 64 64 64 64 64 64 64 64 40 0 0
0 0 16 64 64 64 64 64 64 64 64 64 64 64 64 64 64 64 64 64 64 64 64 64 64 48 0 0 0 0 0 40 64 64 64 64 64 64 14 0 0 0 0 0 56 64 64 64 64 64 64 64 64 64 64 64 64 64 64 64 64 40 0 0
0 0 16 64 64 64 64 64 64 64 64 64 64 64 64 64 64 64 64 64 64 64 64 64 64 48 0 0 0 0 0 40 64 64 64 64 64 64 16 0 0 0 0 0 56 64 64 64 64 64 64 64 64 64 64 64 64 64 64 64 64 40 0 0
0 0 16 64 64 64 64 64 64 64 64 64 64 64 64 64 64 64 64 64 64 64 64 64 64 48 0 0 0 0 0 40 64 64 64 64 64 64 0 0 0 0 0 0 49 56 56 56 56 59 64 61 56 56 56 56 56 58 64 61 56 35 0 0
0 0 16 64 64 64 64 64 64 64 64 64 64 64 64 64 64 64 64 64 64 64 64 64 64 64 64 64 64 64 64 64 64 64 64 64 64 64 0 0 0 0 0 0 0 0 0 0 0 24 64 40 0 0 0 0 0 16 64 40 0 0 0 0
0 0 16 64 64 64 64 64 64 64 64 64 64 64 64 64 64 64 64 64 64 64 64 64 64 58 40 40 40 40 40 48 64 64 64 64 64 60 0 0 0 0 0 0 0 0 0 0 0 24 64 40 0 0 0 0 0 16 64 40 0 0 0 0
0 0 0 32 32 32 32 32 60 60 32 32 32 60 60 32 40 64 48 32 32 32 32 32 32 24 0 0 0 0 0 0 64 64 64 64 64 46 0 0 0 0 0 0 0 0 0 0 0 24 64 40 0 0 0 0 0 16 64 40 0 0 0 0
0 0 0 0 0 0 0 15 59 59 0 0 0 56 56 0 17 64 33 0 0 0 0 0 0 0 0 0 0 0 0 0 56 64 64 64 64 49 32 32 32 32 32 36 64 64 64 64 64 64 64 64 64 64 64 64 24 16 64 40 0 0 0 0
0 0 45 0 0 0 0 40 64 64 32 0 0 56 56 0 30 64 46 0 0 0 0 0 0 0 0 0 0 0 0 0 29 64 64 64 64 64 64 64 64 64 64 64 64 64 64 64 64 64 64 64 64 64 64 64 24 16 64 40 0 0 0 0
0 14 64 33 0 0 0 40 64 64 32 0 0 56 56 0 40 64 59 24 24 24 24 15 0 0 0 0 0 0 0 0 0 54 64 64 30 16 16 16 16 16 16 22 64 64 64 64 64 64 64 64 64 64 64 64 24 16 64 40 0 0 0 0
0 28 64 54 32 32 32 52 64 64 32 0 0 56 56 0 35 64 64 64 64 64 64 40 0 0 0 0 0 0 0 0 0 40 64 27 0 0 0 0 0 0 0 0 64 64 64 64 64 64 64 64 64 64 64 64 64 64 64 40 0 0 0 0
0 36 64 64 64 64 64 64 64 64 32 0 0 56 56 0 0 24 24 24 24 39 64 40 0 0 0 0 0 0 0 0 0 40 64 16 0 0 0 0 22 25 0 0 64 64 64 64 64 64 64 64 64 64 64 64 64 64 64 40 0 0 0 0
0 40 64 64 32 32 32 52 64 64 32 0 0 56 56 0 0 0 0 0 0 24 64 40 0 0 0 0 0 0 0 0 0 40 64 16 0 0 0 0 48 55 16 22 64 64 64 64 64 64 64 64 64 64 64 64 29 22 64 40 0 0 0 0
0 47 64 64 0 0 0 30 48 48 24 0 0 56 56 0 0 16 23 25 32 44 64 52 32 32 30 24 20 14 0 0 0 40 64 16 0 0 0 0 60 64 64 64 64 64 64 64 64 64 64 64 64 64 64 64 24 16 64 40 0 0 0 0
0 48 64 64 0 0 0 0 0 0 0 0 26 60 63 64 64 64 64 64 64 64 64 64 64 64 64 64 64 64 64 60 49 55 64 16 0 0 0 0 64 64 36 36 64 64 64 64 64 64 64 64 64 64 64 64 24 16 64 40 0 0 0 0
0 46 64 64 0 0 0 0 0 0 40 63 64 64 64 64 64 64 64 64 64 64 64 64 64 64 64 64 64 64 64 64 64 64 64 58 48 48 48 48 64 64 0 0 64 64 64 64 64 64 64 64 64 64 64 64 59 58 64 40 0 0 0 0
0 40 64 63 0 0 0 0 0 27 64 64 64 64 64 64 64 64 64 64 64 64 64 64 64 64 64 64 64 64 64 64 64 64 64 64 64 64 64 64 64 64 0 0 64 64 64 64 64 64 64 64 64 64 64 64 64 64 64 52 32 0 0 0
0 35 64 64 64 64 64 64 64 64 64 64 64 64 64 64 64 64 64 64 64 64 64 64 64 64 64 64 64 64 64 64 64 64 64 47 15 0 0 0 54 57 0 0 64 64 64 64 64 64 64 64 64 64 64 64 34 28 64 64 64 24 0 0
0 25 64 55 40 40 40 40 40 40 40 40 40 40 43 53 61 64 64 64 64 64 64 64 64 64 64 64 64 64 58 48 37 24 0 0 0 0 0 0 34 38 0 0 64 64 64 64 64 64 64 64 64 64 64 64 24 16 64 64 64 24 0 0
0 0 64 30 0 0 0 0 0 0 0 0 0 0 0 0 0 0 0 16 16 22 24 24 24 18 16 14 0 0 0 0 0 0 0 0 0 0 0 0 0 0 0 0 64 64 64 64 64 64 64 64 64 64 64 64 24 16 64 64 64 24 0 0
0 0 35 0 0 0 0 0 0 0 0 0 0 0 0 0 0 0 0 0 0 0 0 0 0 0 0 0 0 0 0 0 0 0 0 0 0 0 0 0 0 0 0 0 64 64 64 64 64 64 64 64 64 64 64 64 24 0 48 48 48 18 0 0
0 0 0 0 0 0 0 0 0 0 0 0 0 0 0 0 0 0 0 0 0 0 0 0 0 0 0 0 0 0 0 0 0 0 0 0 0 0 0 0 0 0 0 0 0 0 0 0 0 0 0 0 0 0 0 0 0 0 0 0 0 0 0 0
15 0 0 0 0 0 0 0 0 0 0 0 0 0 0 0 0 0 0 0 0 0 0 0 0 0 0 0 0 0 0 0 0 0 0 0 0 0 0 0 0 0 0 0 0 0 0 0 0 0 0 0 0 0 0 0 0 0 0 0 0 0 0 0