0 0 0 0 0 0 0 0 0 0 0 0 0 0 0 0 0 0 0 0 0 0 0 0 0 0 0 0 0 0 0 0 0 0 0 0 0 0 0 0 0 0 0 0 0 0 0 0 0 0 0 0 0 0 0 0 0 0 0 0 0 0 0 0
0 0 0 0 0 0 0 0 0 0 0 0 0 0 0 0 128 217 0 0 135 191 136 0 0 0 0 0 208 256 256 254 209 0 0 0 0 0 0 0 0 0 0 0 0 0 0 0 0 0 0 0 0 157 192 194 168 0 156 0 0 0 0 0
0 0 0 0 0 0 0 0 0 0 0 0 0 0 0 0 128 256 256 178 0 0 144 247 253 207 160 136 238 256 248 239 256 200 0 0 0 176 0 0 0 0 0 0 0 0 0 157 204 246 256 247 176 0 0 0 0 0 0 224 205 0 0 0
0 0 0 0 0 0 0 0 0 0 0 0 0 0 0 0 128 256 256 256 255 182 0 0 142 243 256 240 250 224 150 186 0 0 0 149 0 0 0 0 0 0 165 216 254 256 256 256 249 174 0 0 0 0 0 0 0 0 0 256 256 0 0 0
0 0 0 256 256 256 256 256 254 234 213 190 168 147 0 0 169 256 256 256 256 256 256 208 0 0 0 0 138 0 0 0 0 150 244 256 171 0 0 161 252 256 256 256 256 256 198 0 0 0 0 0 0 0 0 0 0 0 0 256 256 0 0 0
0 0 244 256 256 256 256 256 256 256 256 256 256 256 256 256 256 256 256 256 256 256 256 221 0 0 0 152 212 171 162 168 254 251 219 248 256 0 0 256 256 256 256 234 143 0 0 0 0 0 0 0 0 0 0 0 0 0 134 256 255 0 0 0
0 134 207 197 240 256 256 256 256 256 256 256 256 256 256 256 256 256 256 256 243 129 0 0 0 140 232 256 190 210 218 148 0 0 0 0 0 0 0 256 256 229 188 175 237 256 256 240 255 0 0 0 0 0 0 0 0 0 152 256 249 0 0 0
0 0 136 0 0 0 0 0 160 203 245 256 256 256 256 256 256 256 256 256 256 227 0 0 192 256 256 139 0 183 0 0 0 0 0 0 0 204 256 0 0 241 250 256 256 256 256 252 256 0 0 0 178 232 153 0 0 0 158 240 224 0 0 0
0 0 192 250 155 0 0 0 0 0 0 0 0 0 167 212 252 256 256 256 256 256 235 0 192 245 0 0 0 0 0 0 0 0 0 0 0 228 240 180 0 133 0 163 183 222 253 256 184 0 224 256 256 256 185 0 0 0 173 240 219 0 0 0
0 0 0 256 256 255 192 0 0 0 0 0 0 0 0 0 0 0 0 153 216 256 256 249 164 0 0 0 0 0 0 0 0 0 0 0 0 192 192 202 208 208 0 0 0 0 0 0 220 256 256 256 256 256 0 0 0 0 188 240 208 0 0 0
0 0 0 214 256 256 256 256 250 196 138 0 0 0 0 0 0 0 0 0 0 0 193 192 206 192 188 0 0 0 0 0 0 0 0 0 173 176 176 191 192 192 0 0 0 0 220 256 256 256 256 242 224 206 0 0 0 0 203 240 204 0 0 0
0 0 0 0 253 256 256 256 256 256 256 256 249 153 0 0 0 0 0 0 0 215 0 0 244 256 176 0 0 0 0 0 216 0 0 0 192 192 192 0 0 0 142 228 253 256 256 256 256 256 187 128 128 0 0 0 0 0 235 256 206 0 0 0
0 0 0 0 196 256 256 256 253 256 256 256 256 251 147 0 0 0 0 0 250 256 0 189 256 256 0 0 0 0 138 255 250 0 0 174 176 176 176 0 0 0 144 256 256 256 256 256 250 200 176 176 166 0 0 0 0 0 255 256 192 0 0 0
0 0 0 0 256 256 256 256 240 181 214 256 256 256 256 0 0 0 0 0 198 254 0 256 256 256 0 0 0 192 256 256 178 0 133 192 192 192 192 162 0 0 144 256 256 256 256 250 194 176 176 176 0 0 0 0 0 0 256 256 181 0 0 0
0 0 0 233 256 256 256 256 240 128 0 165 256 256 256 0 0 0 164 256 256 256 212 256 256 256 254 229 256 256 256 256 0 0 201 192 192 192 192 215 149 0 144 256 256 256 256 210 192 192 192 172 0 0 0 0 0 0 256 256 166 0 0 0
0 0 151 256 256 256 217 179 180 0 0 0 256 256 249 0 0 0 242 256 256 256 256 256 256 256 256 256 256 251 240 212 0 168 256 256 256 256 256 256 256 212 182 256 256 246 158 128 128 128 128 0 0 0 0 0 0 0 256 256 148 0 0 0
0 0 253 232 0 0 0 0 0 0 176 176 247 256 189 0 0 0 224 224 226 230 224 239 256 256 256 256 253 240 240 0 0 206 209 253 256 256 256 256 256 256 256 256 256 0 0 0 0 0 0 0 0 0 0 0 0 146 256 256 0 0 0 0
0 0 135 0 0 0 0 0 0 0 240 240 253 256 0 0 0 131 0 0 177 0 0 0 211 256 256 233 211 208 201 0 143 207 199 256 256 256 256 256 256 256 256 256 256 256 256 256 256 256 0 0 0 0 0 0 0 200 256 256 0 0 0 0
0 147 0 0 0 0 0 0 0 0 256 252 240 228 0 0 0 192 192 0 192 0 0 0 0 208 208 208 208 208 0 0 250 159 140 149 0 219 256 256 256 256 256 256 256 249 240 240 240 216 0 0 0 0 0 0 0 251 256 256 0 0 0 0
0 145 0 0 0 0 0 0 0 133 256 239 224 0 0 0 0 0 0 0 192 0 0 0 0 204 208 208 208 202 0 129 237 0 0 0 0 0 0 195 256 256 256 256 256 256 256 256 256 138 0 0 0 0 0 0 0 256 256 256 0 0 0 0
0 164 0 0 0 227 0 0 0 197 256 256 253 0 0 0 0 0 0 0 138 0 0 0 0 153 176 176 176 0 0 227 227 138 0 0 163 163 141 0 0 165 252 256 256 256 256 256 256 0 0 0 0 0 0 0 174 240 240 219 0 0 0 0
0 181 0 0 223 256 169 0 0 251 256 256 188 0 0 0 0 195 256 256 0 146 256 256 256 201 176 176 180 0 0 255 240 136 242 256 240 240 256 256 249 169 0 145 247 256 256 256 249 0 0 0 0 0 0 0 239 240 238 250 144 0 0 0
0 199 0 0 256 256 203 0 0 256 250 240 136 135 0 174 0 0 0 0 152 0 240 240 240 199 192 192 131 0 143 256 0 240 256 256 240 240 256 256 256 256 195 0 0 157 254 236 222 0 0 0 0 0 0 0 0 0 228 256 256 225 0 0
0 211 0 144 256 229 198 0 146 256 211 0 144 237 0 146 0 0 172 256 256 138 240 240 238 192 192 190 0 0 207 256 130 240 256 256 242 244 256 256 256 256 256 0 0 0 0 0 196 0 0 0 0 0 204 0 0 248 256 256 256 253 185 0
0 196 0 194 256 256 240 0 209 256 256 0 144 253 256 0 0 0 0 256 254 0 240 240 226 192 192 136 0 0 249 256 230 243 256 256 256 256 256 256 256 254 133 0 0 0 0 0 151 247 179 161 196 253 256 179 256 256 256 213 0 0 0 0
0 168 0 223 256 0 0 0 253 256 256 219 228 256 224 0 0 176 202 256 208 0 256 256 205 160 165 0 0 0 160 160 183 256 256 256 256 256 256 256 254 148 0 0 0 0 0 152 0 256 256 256 256 256 256 256 250 164 0 0 0 0 147 0
0 145 143 240 256 256 240 0 256 256 256 249 224 224 0 0 0 154 256 256 138 0 240 240 181 160 136 0 0 0 225 256 240 256 256 256 256 256 244 156 0 0 0 0 0 0 146 256 256 256 256 230 163 256 244 137 0 0 0 224 243 256 0 0
0 0 206 191 209 225 198 0 256 256 256 256 216 0 0 0 0 0 186 256 0 0 256 256 143 0 0 0 0 0 0 241 240 256 242 198 143 0 0 0 0 0 0 0 0 0 0 0 0 0 0 0 0 167 0 0 0 0 0 256 256 142 0 0
0 0 0 0 0 256 213 0 247 256 256 256 219 0 0 0 0 0 204 240 0 0 256 256 0 0 0 254 195 128 0 0 0 0 0 0 0 0 0 0 0 0 155 196 246 256 0 0 0 0 0 0 0 0 225 246 0 0 0 256 256 0 0 0
0 0 0 0 0 250 191 0 0 215 186 0 0 0 0 0 237 0 250 169 0 0 224 0 0 0 0 174 226 255 256 240 256 256 256 256 240 240 256 256 256 256 246 226 198 157 0 0 0 0 163 176 0 0 0 152 0 0 144 231 0 0 0 0
0 0 0 0 0 0 164 0 0 0 0 0 0 0 0 0 0 0 162 0 0 143 0 0 0 0 0 0 0 0 0 0 0 0 0 0 0 0 0 0 0 0 0 0 0 0 0 0 0 0 0 0 135 0 0 0 0 0 143 0 0 0 0 0
0 0 0 0 0 0 0 0 0 0 0 0 0 0 0 0 0 0 0 0 0 0 0 0 0 0 0 0 0 0 0 0 0 0 0 0 0 0 0 0 0 0 0 0 0 0 0 0 0 0 0 0 0 0 0 0 0 0 0 0 0 0 0 0