94 128 128 128 128 128 78 0 0 0 0 0 0 0 97 128 128 128 128 0 0 88 128 128 128 128 128 128 128 128 128 128 128 128 128 128 128 128 128 128 128 128 128 128 128 128 128 128 128 128 128 128 128 128 128 128 128 128 128 128 128 128 128 80
160 256 256 256 256 256 166 0 0 0 0 0 0 0 52 246 256 256 256 91 0 145 256 256 256 256 256 256 256 256 256 256 256 256 256 256 256 256 256 256 256 256 256 256 256 256 256 256 256 256 256 256 256 256 256 256 256 256 256 256 256 256 256 128
160 256 256 256 256 256 191 0 123 215 186 106 0 0 0 63 237 256 256 169 0 123 256 256 256 256 256 256 256 256 256 256 256 256 256 256 256 256 256 256 256 256 256 256 256 256 256 256 256 256 256 256 71 229 256 256 247 71 152 256 256 256 256 128
160 256 256 253 256 256 213 0 256 256 256 256 219 0 0 0 0 218 256 240 0 108 256 256 256 256 256 254 195 128 83 62 66 0 0 0 0 0 54 72 96 122 155 196 246 256 256 256 256 256 256 256 132 61 244 246 84 0 78 256 256 256 256 128
160 256 206 233 256 256 225 64 256 256 256 256 256 225 0 0 0 126 256 256 63 96 256 256 256 256 234 0 0 0 78 241 256 256 242 198 143 77 0 0 0 0 0 0 0 79 231 256 256 256 256 256 256 167 0 0 0 0 0 256 256 256 256 128
160 256 143 240 256 256 240 0 256 256 256 256 256 256 128 0 0 154 256 256 138 88 256 256 256 256 203 0 0 0 225 256 256 256 256 256 256 256 244 156 0 0 0 0 0 0 146 256 256 256 256 256 256 256 244 137 0 0 0 234 256 256 256 128
160 256 92 223 256 256 240 0 253 256 256 256 256 256 224 0 0 238 256 256 208 80 256 256 256 256 256 52 0 0 256 256 256 256 256 256 256 256 256 256 254 148 0 0 0 0 99 256 256 256 256 256 256 256 256 256 250 164 58 62 104 121 147 60
160 256 0 194 256 256 240 0 209 256 256 256 256 256 256 0 153 256 256 256 254 95 256 256 256 256 256 176 0 0 249 256 256 256 256 256 256 256 256 256 256 256 194 0 0 0 0 144 256 247 179 161 196 253 256 256 256 256 256 213 116 0 0 0
160 252 0 144 256 256 224 0 146 256 256 256 256 256 256 199 256 256 256 256 256 143 256 256 256 256 256 254 0 0 207 256 256 256 256 256 256 256 256 256 256 256 256 69 0 0 63 235 256 56 0 0 0 0 204 256 256 256 256 256 256 253 185 70
160 221 0 69 256 256 203 0 78 256 256 256 143 141 256 256 256 256 256 256 194 123 256 256 256 256 256 256 165 0 143 256 256 256 256 256 256 256 256 256 256 256 240 0 0 157 254 256 236 0 0 0 0 0 0 215 256 256 256 256 256 256 256 128
160 188 0 0 223 256 169 0 0 251 256 256 188 0 149 256 256 256 256 256 0 146 256 256 256 256 256 256 253 0 64 256 256 138 242 256 256 256 256 256 249 169 66 145 247 256 256 256 249 0 0 0 0 0 0 56 255 256 256 256 256 256 256 128
160 164 0 0 100 256 106 0 0 197 256 256 253 0 0 197 256 256 256 256 182 237 256 256 256 256 256 256 256 154 0 227 256 161 0 126 172 172 141 84 67 165 252 256 256 256 256 256 256 55 0 0 0 0 0 0 185 256 256 256 256 256 256 128
160 145 0 0 0 98 0 0 0 133 256 256 256 134 0 0 245 256 256 256 256 256 256 256 256 256 256 256 256 248 0 129 256 255 82 0 0 0 82 195 256 256 256 256 256 256 256 256 256 138 0 0 0 0 0 0 88 256 256 256 256 256 256 128
160 167 0 0 0 0 0 0 0 83 256 256 256 239 0 0 121 256 256 256 256 256 256 256 256 256 256 256 256 256 138 0 250 256 252 149 122 219 256 256 256 256 256 256 256 256 256 256 256 233 0 0 0 0 0 0 0 251 256 256 256 256 256 128
160 255 135 0 0 0 0 0 0 0 256 256 256 256 99 0 0 226 256 256 256 256 256 256 256 256 256 256 256 256 242 0 163 256 256 256 256 256 256 256 256 256 256 256 256 256 256 256 256 256 98 0 0 0 0 0 0 200 256 256 256 256 256 128
160 256 256 232 126 0 0 0 0 95 256 256 256 256 189 0 0 105 256 256 256 256 256 256 256 256 256 256 256 256 256 115 0 254 256 256 256 256 256 256 256 256 256 256 256 256 256 256 256 256 220 0 0 0 0 0 0 146 256 256 256 256 256 128
160 256 256 256 256 256 217 179 189 251 256 256 256 256 249 0 0 0 242 256 256 256 256 256 256 256 256 256 256 256 256 225 0 168 256 256 256 256 256 256 256 256 256 256 256 256 256 256 256 256 256 98 0 0 0 0 0 99 256 256 256 256 256 128
160 256 256 256 256 256 256 256 256 256 256 256 256 256 256 0 0 0 164 256 256 256 256 256 256 256 254 229 256 256 256 256 77 0 255 256 256 256 256 256 256 256 256 256 256 256 256 256 256 256 256 223 0 0 0 0 0 63 256 256 256 256 256 128
160 256 256 256 256 256 256 256 256 256 256 256 256 256 256 0 0 0 0 250 256 256 256 256 256 256 125 0 0 192 256 256 178 0 166 256 256 256 256 256 256 256 256 256 256 256 256 256 256 256 256 256 110 0 0 0 0 0 256 256 256 256 256 128
160 256 256 256 256 256 256 256 256 256 256 256 256 256 179 0 0 0 0 83 250 256 256 256 256 256 107 0 0 0 138 255 250 0 0 251 256 256 256 256 256 256 256 256 256 256 256 256 256 256 256 256 232 0 0 0 0 0 255 256 256 256 256 128
160 256 256 256 256 256 256 256 256 256 256 256 249 153 0 0 0 0 0 0 0 215 256 256 256 256 176 0 0 0 0 78 218 0 0 148 256 256 256 256 256 256 254 228 253 256 256 256 256 256 256 256 256 124 0 0 0 0 235 256 256 256 256 128
160 256 256 256 256 256 256 256 250 196 138 80 0 0 0 0 0 0 0 0 0 62 256 256 256 256 252 0 0 0 0 0 0 0 0 0 243 256 256 256 256 256 113 0 0 107 220 256 256 256 256 256 256 236 0 0 0 0 216 256 256 256 256 128
160 256 256 256 256 255 192 92 0 0 0 0 0 0 0 0 0 0 101 153 216 256 256 256 256 256 256 199 0 0 0 0 0 0 0 0 125 256 256 256 256 256 84 0 0 0 0 105 220 256 256 256 256 256 103 0 0 0 199 256 256 256 256 128
160 256 256 250 155 0 0 0 0 0 0 0 79 123 167 212 252 256 256 256 256 256 256 256 256 256 256 256 164 0 0 0 0 0 0 0 0 243 256 256 256 256 230 163 183 222 253 256 188 110 224 256 256 256 185 0 0 0 183 256 256 256 256 128
160 256 195 0 0 0 72 115 160 203 245 256 256 256 256 256 256 256 256 256 256 256 256 256 256 256 256 256 256 183 0 0 0 0 0 0 0 204 256 256 256 256 256 256 256 256 256 256 256 72 0 86 178 232 154 0 0 0 167 256 256 256 256 128
160 256 207 197 240 256 256 256 256 256 256 256 256 256 256 256 256 256 256 256 256 256 256 234 117 140 232 256 256 256 245 148 59 0 0 0 87 251 256 256 256 229 188 175 237 256 256 256 255 0 0 0 0 0 0 0 0 0 152 256 256 256 256 128
160 256 256 256 256 256 256 256 256 256 256 256 256 256 256 256 256 256 256 256 256 256 256 221 0 0 0 152 256 256 186 168 254 251 233 248 256 256 256 256 256 256 256 234 143 83 87 103 52 0 0 0 0 0 0 0 0 0 134 256 256 256 256 128
160 256 256 256 256 256 256 256 256 256 256 256 256 256 256 256 256 256 256 256 256 256 256 209 0 0 97 130 163 256 250 75 0 150 247 256 256 256 256 256 256 256 256 256 256 256 198 102 0 0 0 0 0 0 0 0 0 0 110 256 256 256 256 128
160 256 256 256 256 256 256 256 256 256 256 256 256 256 256 256 256 256 256 256 255 182 89 0 142 243 256 256 250 249 256 250 105 0 0 149 255 256 256 256 256 256 256 256 256 256 256 256 249 174 88 0 0 0 0 0 0 0 75 256 256 256 256 128
160 256 256 256 256 256 256 256 256 256 256 256 256 256 256 256 256 256 256 178 0 0 144 247 256 256 256 256 256 256 256 256 256 204 0 0 174 256 256 256 256 256 256 256 256 256 256 256 256 256 256 247 176 100 0 0 0 0 0 256 256 256 256 128
160 256 256 256 256 256 256 256 256 256 256 256 256 256 256 256 256 217 69 0 139 247 256 256 256 256 256 256 256 256 256 254 209 122 0 101 249 256 256 256 256 256 256 256 256 256 256 256 256 256 256 256 256 256 256 227 176 147 173 256 256 256 256 128
103 144 144 144 144 144 144 144 144 144 144 144 144 144 144 144 125 0 0 132 144 144 144 144 144 144 144 144 136 103 67 0 0 0 114 144 144 144 144 144 144 144 144 144 144 144 144 144 144 144 144 144 144 144 144 144 144 144 144 144 144 144 144 87