0 0 0 0 0 0 0 0 0 0 0 0 0 0 0 0 0 0 0 0 0 0 0 0 0 0 0 0 0 0 0 0 0 0 0 0 0 0 0 0 0 0 0 0 0 0 0 0 0 0 0 0 0 0 0 0 0 0 0 0
0 0 0 0 0 0 0 0 0 0 0 0 0 0 0 0 0 0 0 0 0 0 0 0 0 0 0 0 0 0 0 0 0 0 0 0 0 0 0 0 0 0 0 0 0 0 0 0 0 0 0 0 0 0 0 0 0 0 0 0
0 0 0 0 0 0 0 0 0 0 0 0 0 0 0 0 0 0 0 0 0 0 0 0 0 0 0 0 0 0 0 0 0 0 0 0 0 0 0 0 0 0 0 0 0 0 0 0 0 0 0 0 0 0 0 0 0 0 0 0
0 0 0 0 0 0 0 0 0 0 0 0 0 0 0 0 0 0 0 0 0 0 0 0 0 0 0 0 0 0 0 0 0 0 0 0 0 0 0 0 0 0 0 0 0 0 0 0 0 0 0 0 0 0 0 0 0 0 0 0
0 0 0 0 0 0 0 0 0 27 13 0 0 0 0 0 0 0 0 0 0 0 0 0 0 0 0 0 0 0 0 0 0 0 0 0 0 0 15 56 104 143 188 218 224 224 224 224 224 219 135 7 0 0 0 0 0 0 0 0
0 0 0 0 0 0 9 131 217 256 233 88 3 0 0 0 0 0 0 0 0 0 0 0 0 0 0 0 0 0 0 0 0 0 0 7 78 191 255 256 256 256 256 256 256 256 256 256 256 256 256 206 28 0 0 0 0 0 0 0
0 0 0 0 0 8 174 256 256 256 256 256 160 0 0 0 0 0 0 0 0 0 0 0 0 0 0 0 0 0 0 0 0 0 89 225 256 256 256 237 193 150 104 71 64 64 64 64 64 102 239 256 238 62 0 0 0 0 0 0
0 0 0 0 0 100 256 256 256 256 256 256 256 99 0 0 0 0 0 0 0 0 0 0 0 0 0 0 0 0 0 0 16 162 256 256 236 148 37 0 0 0 0 0 0 0 0 0 0 0 38 212 256 246 53 0 0 0 0 0
0 0 0 0 0 152 256 256 256 256 256 256 256 250 189 162 103 57 30 2 0 0 0 0 0 0 0 0 0 0 0 41 216 256 255 139 11 0 0 0 16 113 185 208 208 173 43 0 0 0 0 10 194 256 213 3 0 0 0 0
0 0 0 0 0 160 256 256 256 256 256 256 256 256 256 256 256 256 256 239 193 154 113 70 26 0 0 0 0 1 116 249 256 234 68 0 0 0 0 113 245 256 256 256 256 256 239 14 0 0 0 0 21 238 256 90 0 0 0 0
0 0 0 0 0 160 256 256 256 256 256 256 256 256 256 182 190 237 254 256 256 256 256 256 256 240 194 149 109 185 256 256 190 32 0 0 0 1 152 256 256 256 256 256 256 256 256 39 0 0 0 0 0 133 256 195 0 0 0 0
0 0 0 0 0 160 256 256 256 256 256 256 256 256 256 121 0 0 8 56 103 138 176 221 253 256 256 256 256 256 256 255 196 146 111 53 6 108 256 256 256 256 256 256 256 256 210 1 0 0 0 0 0 31 256 254 14 0 0 0
0 0 0 0 0 111 256 256 256 256 256 256 256 256 256 128 0 0 0 0 0 0 0 0 15 54 105 249 256 253 256 256 256 256 256 256 244 249 256 256 256 256 256 256 256 256 237 8 0 0 0 0 0 0 256 256 32 0 0 0
0 0 0 0 0 20 246 256 256 256 256 256 256 256 256 98 0 0 0 0 0 0 0 0 0 0 163 256 243 50 22 58 104 142 187 240 256 256 256 256 256 256 256 256 256 256 256 46 0 0 0 0 0 0 256 256 32 0 0 0
0 0 0 0 0 0 115 256 256 256 256 256 256 256 235 14 0 0 0 0 0 0 0 0 0 108 256 255 81 0 0 0 0 0 0 76 256 256 256 256 256 256 256 256 256 256 256 48 0 0 0 0 0 8 256 256 32 0 0 0
0 0 0 0 0 0 0 183 256 256 256 256 256 255 88 0 0 0 0 0 16 112 158 160 133 249 256 127 0 0 0 0 0 0 0 112 256 256 256 256 256 256 256 256 256 256 256 48 0 0 0 0 0 91 256 233 7 0 0 0
0 0 0 0 0 0 0 15 174 256 256 256 256 133 0 0 0 0 0 68 236 256 256 256 256 256 204 3 0 0 0 0 0 0 0 66 256 256 256 256 256 256 256 256 256 256 242 14 0 0 0 0 0 191 256 136 0 0 0 0
0 0 0 0 0 0 0 0 0 86 199 256 227 1 0 0 0 0 26 245 256 256 256 256 256 256 250 34 0 0 0 0 0 0 0 0 182 256 256 256 256 256 256 256 256 256 114 0 0 0 0 0 45 255 256 38 0 0 0 0
0 0 0 0 0 0 0 0 0 0 20 252 256 58 0 0 0 0 66 256 256 256 256 256 256 256 256 77 0 0 0 0 0 0 0 1 97 256 256 256 256 256 256 256 256 153 1 0 0 0 0 0 155 256 179 0 0 0 0 0
0 0 0 0 0 0 0 0 0 0 0 168 256 164 0 0 0 0 0 171 256 256 256 256 256 256 256 53 0 0 0 5 45 90 149 231 256 256 250 144 189 234 256 240 124 3 0 0 0 0 0 59 249 256 71 0 0 0 0 0
0 0 0 0 0 0 0 0 0 0 0 62 256 246 20 0 0 0 0 15 150 251 256 256 256 256 250 192 192 193 218 250 256 256 256 256 245 171 44 0 0 0 0 0 0 0 0 0 0 0 86 242 256 175 0 0 0 0 0 0
0 0 0 0 0 0 0 0 0 0 0 1 214 256 169 3 0 0 0 0 0 61 223 256 256 256 256 256 256 256 256 256 246 200 157 82 10 0 0 0 0 0 0 0 0 0 0 2 60 175 256 256 201 14 0 0 0 0 0 0
0 0 0 0 0 0 0 0 0 0 0 0 66 253 256 221 119 35 0 0 0 0 4 56 93 96 96 96 96 96 72 39 2 0 0 0 0 0 0 0 0 1 26 32 61 94 144 214 256 256 255 138 7 0 0 0 0 0 0 0
0 0 0 0 0 0 0 0 0 0 0 0 0 83 240 256 256 256 232 197 147 108 96 96 96 96 96 96 96 96 99 137 182 208 214 238 240 240 256 256 256 256 256 256 256 256 256 256 247 172 60 0 0 0 0 0 0 0 0 0
0 0 0 0 0 0 0 0 0 0 0 0 0 0 14 106 201 256 256 256 256 256 256 256 256 256 256 256 256 256 256 256 256 256 256 256 256 256 256 256 256 256 256 255 235 196 145 101 23 0 0 0 0 0 0 0 0 0 0 0
0 0 0 0 0 0 0 0 0 0 0 0 0 0 0 0 0 17 58 94 144 180 192 192 192 192 192 192 192 192 191 159 117 69 64 50 48 48 27 16 16 16 8 0 0 0 0 0 0 0 0 0 0 0 0 0 0 0 0 0
0 0 0 0 0 0 0 0 0 0 0 0 0 0 0 0 0 0 0 0 0 0 0 0 0 0 0 0 0 0 0 0 0 0 0 0 0 0 0 0 0 0 0 0 0 0 0 0 0 0 0 0 0 0 0 0 0 0 0 0
0 0 0 0 0 0 0 0 0 0 0 0 0 0 0 0 0 0 0 0 0 0 0 0 0 0 0 0 0 0 0 0 0 0 0 0 0 0 0 0 0 0 0 0 0 0 0 0 0 0 0 0 0 0 0 0 0 0 0 0
0 0 0 0 0 0 0 0 0 0 0 0 0 0 0 0 0 0 0 0 0 0 0 0 0 0 0 0 0 0 0 0 0 0 0 0 0 0 0 0 0 0 0 0 0 0 0 0 0 0 0 0 0 0 0 0 0 0 0 0
0 0 0 0 0 0 0 0 0 0 0 0 0 0 0 0 0 0 0 0 0 0 0 0 0 0 0 0 0 0 0 0 0 0 0 0 0 0 0 0 0 0 0 0 0 0 0 0 0 0 0 0 0 0 0 0 0 0 0 0