0 0 0 0 0 0 0 0 0 0 0 0 0 0 0 0 0 0 64 64 64 64 64 64 64 64 64 64 64 64 64 64 64 64 64 64 64 64 64 64 64 64 64 64 64 64 64 0 0 0 0 0 0 0 0 0 0 0 0 0 0 0 0 0
0 0 0 0 0 0 0 0 0 0 0 0 0 0 0 0 0 0 256 243 240 240 240 240 240 240 240 240 240 240 240 240 240 240 240 240 240 240 240 240 240 240 240 240 240 240 253 80 0 0 0 0 0 0 0 0 0 0 0 0 0 0 0 0
0 0 0 128 128 128 128 128 128 128 128 128 128 128 128 128 128 152 256 152 128 128 128 128 128 88 0 0 0 0 0 0 0 0 0 0 0 0 0 0 0 0 0 0 0 0 208 80 0 0 0 0 0 0 0 0 0 0 0 0 0 0 0 0
0 0 80 256 256 256 256 256 256 256 256 256 256 256 256 256 256 256 256 256 256 256 256 256 256 176 0 0 0 0 0 0 0 86 226 177 0 0 0 0 0 0 0 0 0 0 208 80 0 0 0 0 0 0 0 0 0 0 0 0 0 0 0 0
0 0 80 256 256 256 256 256 256 256 256 256 256 256 256 256 256 256 256 256 256 256 256 256 256 176 0 0 0 0 0 0 0 251 256 256 168 0 0 0 0 0 0 0 210 240 253 245 240 240 240 240 240 240 240 240 240 240 240 240 240 150 0 0
0 0 80 256 256 256 256 256 256 256 256 256 256 256 256 256 256 256 256 256 256 256 256 256 256 176 0 0 0 0 0 0 174 256 256 256 256 0 0 0 0 0 0 0 224 256 256 256 256 256 256 256 256 256 256 256 256 256 256 256 256 160 0 0
0 0 80 256 256 256 256 256 256 256 256 256 256 256 256 256 256 256 256 256 256 256 256 256 256 176 0 0 0 0 0 0 251 256 256 256 256 155 0 0 0 0 0 0 230 256 256 256 256 256 256 256 256 256 256 256 256 256 256 256 256 160 0 0
0 0 80 256 256 256 256 256 256 256 256 256 256 256 256 256 256 256 256 256 256 256 256 256 256 176 0 0 0 0 0 74 256 256 256 256 256 256 256 256 256 256 256 256 256 256 256 256 256 256 256 256 256 256 256 256 256 256 256 256 256 160 0 0
0 0 80 256 256 256 256 256 256 256 256 256 256 256 256 256 256 256 256 256 256 256 256 256 256 176 0 0 0 0 0 122 256 256 256 256 256 251 0 0 0 0 0 0 228 256 256 256 256 256 256 256 256 256 256 256 256 256 256 256 256 160 0 0
0 0 80 256 256 256 256 256 256 256 256 256 256 256 256 256 256 256 256 256 256 256 256 256 256 176 0 0 0 0 0 154 256 256 256 256 256 256 0 0 0 0 0 0 224 256 256 256 256 256 256 256 256 256 256 256 256 256 256 256 256 160 0 0
0 0 80 256 256 256 256 256 256 256 256 256 256 256 256 256 256 256 256 256 256 256 256 256 256 176 0 0 0 0 0 172 256 256 256 256 256 256 0 0 0 0 0 0 224 256 256 256 256 256 256 256 256 256 256 256 256 256 256 256 256 160 0 0
0 0 80 256 256 256 256 256 256 256 256 256 256 256 256 256 256 256 256 256 256 256 256 256 256 176 0 0 0 0 0 176 256 256 256 256 256 256 0 0 0 0 0 0 224 256 256 256 256 256 256 256 256 256 256 256 256 256 256 256 256 160 0 0
0 0 80 256 256 256 256 256 256 256 256 256 256 256 256 256 256 256 256 256 256 256 256 256 256 176 0 0 0 0 0 166 256 256 256 256 256 256 0 0 0 0 0 0 196 224 224 224 224 228 256 238 224 224 224 224 224 224 246 224 224 140 0 0
0 0 80 256 256 256 256 256 256 256 256 256 256 256 256 256 256 256 256 256 256 256 256 256 256 216 128 128 128 128 128 204 256 256 256 256 256 256 0 0 0 0 0 0 0 0 0 0 0 0 256 112 0 0 0 0 0 0 176 0 0 0 0 0
0 0 80 256 256 256 256 256 256 256 256 256 256 256 256 256 256 256 256 256 256 256 256 256 256 226 160 160 160 160 160 194 256 256 256 256 256 234 0 0 0 0 0 0 0 0 0 0 0 0 256 112 0 0 0 0 0 0 188 0 0 0 0 0
0 0 0 128 128 128 128 128 240 168 128 128 128 224 192 128 128 248 136 128 128 128 128 128 128 88 0 0 0 0 0 53 256 256 256 256 256 181 0 0 0 0 0 0 0 0 0 0 0 0 256 112 0 0 0 0 0 0 226 0 0 0 0 0
0 0 0 0 0 0 0 66 236 146 0 0 0 192 128 0 0 253 84 0 0 0 0 0 0 0 0 0 0 0 0 0 232 256 256 256 256 152 64 64 64 64 64 88 256 256 256 256 256 256 256 256 256 256 256 256 80 0 249 0 0 0 0 0
0 0 179 0 0 0 0 176 256 256 128 0 0 192 128 0 127 256 175 0 0 0 0 0 0 0 0 0 0 0 0 0 130 256 256 256 256 256 256 256 256 256 256 256 256 256 256 256 256 256 256 256 256 256 256 256 80 59 256 0 0 0 0 0
0 58 256 122 0 0 0 176 256 256 128 0 0 192 128 0 159 256 222 80 80 80 80 0 0 0 0 0 0 0 0 0 0 218 256 256 102 0 0 0 0 0 0 0 256 256 256 256 256 256 256 256 256 256 256 256 80 70 256 0 0 0 0 0
0 115 256 199 80 80 80 201 256 256 128 0 0 192 128 0 147 256 256 256 256 256 256 0 0 0 0 0 0 0 0 0 0 70 256 97 0 0 0 0 0 0 0 0 256 256 256 256 256 256 256 256 256 256 256 256 80 80 256 0 0 0 0 0
0 152 256 256 256 256 256 256 256 256 128 0 0 192 128 0 87 256 135 0 0 64 256 0 0 0 0 0 0 0 0 0 0 64 256 0 0 0 0 0 89 89 0 0 256 256 256 256 256 256 256 256 256 256 256 256 234 234 256 0 0 0 0 0
0 174 256 246 96 96 96 206 256 256 128 0 0 192 128 0 0 118 0 0 0 64 256 0 0 0 0 0 0 0 0 0 0 64 256 0 0 0 0 0 200 202 0 0 256 256 256 256 256 256 256 256 256 256 256 256 102 102 256 0 0 0 0 0
0 190 256 254 0 0 0 132 192 192 96 0 0 192 128 0 0 58 82 99 112 156 256 144 128 116 107 91 71 0 0 0 0 64 256 0 0 0 0 0 247 256 256 256 256 256 256 256 256 256 256 256 256 256 256 256 80 71 256 0 0 0 0 0
0 192 256 256 0 0 0 0 0 0 0 0 99 227 238 250 256 256 256 256 256 256 256 256 256 256 256 256 256 256 256 232 187 169 256 0 0 0 0 0 256 256 106 116 256 256 256 256 256 256 256 256 256 256 256 256 80 60 256 0 0 0 0 0
0 188 256 252 0 0 0 0 0 0 157 252 256 256 256 256 256 256 256 256 256 256 256 256 256 256 256 256 256 256 256 256 256 256 256 220 110 96 96 106 256 256 0 0 256 256 256 256 256 256 256 256 256 256 256 256 190 178 250 0 0 0 0 0
0 172 256 236 0 0 0 0 0 93 256 256 256 256 256 256 256 256 256 256 256 256 256 256 256 256 256 256 256 256 256 256 256 256 256 256 241 192 192 192 254 254 0 0 256 256 256 256 256 256 256 256 256 256 256 256 102 0 222 0 0 0 0 0
0 148 256 241 144 144 144 144 144 147 244 256 256 256 256 256 256 256 256 256 256 256 256 256 256 256 256 256 256 256 256 256 256 256 255 190 0 0 0 0 222 222 0 0 256 256 256 256 256 256 256 256 256 256 256 256 80 0 118 0 0 0 0 0
0 110 256 204 112 112 112 112 112 112 112 112 112 130 178 221 251 256 256 256 256 256 256 256 256 256 256 256 256 256 238 200 155 100 0 0 0 0 0 0 146 146 0 0 256 256 256 256 256 256 256 256 256 256 256 256 80 0 0 0 0 0 0 0
0 0 256 113 0 0 0 0 0 0 0 0 0 0 0 0 0 0 0 67 80 92 96 96 96 84 75 59 0 0 0 0 0 0 0 0 0 0 0 0 0 0 0 0 256 256 256 256 256 256 256 256 256 256 256 256 80 0 0 0 0 0 0 0
0 0 147 0 0 0 0 0 0 0 0 0 0 0 0 0 0 0 0 0 0 0 0 0 0 0 0 0 0 0 0 0 0 0 0 0 0 0 0 0 0 0 0 0 256 256 256 256 256 256 256 256 256 256 256 256 80 0 0 0 0 0 0 0
0 0 0 0 0 0 0 0 0 0 0 0 0 0 0 0 0 0 0 0 0 0 0 0 0 0 0 0 0 0 0 0 0 0 0 0 0 0 0 0 0 0 0 0 0 0 0 0 0 0 0 0 0 0 0 0 0 0 0 0 0 0 0 0
0 0 0 0 0 0 0 0 0 0 0 0 0 0 0 0 0 0 0 0 0 0 0 0 0 0 0 0 0 0 0 0 0 0 0 0 0 0 0 0 0 0 0 0 0 0 0 0 0 0 0 0 0 0 0 0 0 0 0 0 0 0 0 0