0 0 0 0 0 0 0 0 0 0 0 0 0 0 0 0 0 0 0 0 0 0 0 0 0 0 0 0 0 0 0 0 0 0 0 0 0 0 0 0 0 0 0 0 0 0 0 0 0 0 0 0 0 0 0 0 0 0 0 0 0 0 0 0
0 0 0 137 224 224 137 0 0 0 0 0 0 0 0 0 0 0 0 0 0 128 221 227 145 0 0 0 0 0 0 0 0 0 0 0 0 0 0 0 0 0 0 0 0 54 158 187 185 180 187 185 172 170 107 0 0 0 0 0 0 0 0 0
0 0 161 256 256 256 256 161 0 0 0 0 0 0 0 0 0 0 0 0 145 256 256 256 256 252 240 240 240 240 240 240 240 240 240 240 240 240 240 240 240 240 240 242 256 256 256 256 256 256 256 256 256 256 256 255 167 0 0 0 0 0 0 0
0 0 254 256 256 256 256 254 0 0 0 0 0 0 0 0 0 0 0 0 249 256 256 256 256 256 140 112 119 115 112 112 112 112 112 112 112 112 112 112 112 112 112 111 218 256 256 256 256 256 256 256 256 256 256 256 256 250 108 0 0 0 0 0
0 0 256 256 256 256 256 256 0 0 0 0 0 0 0 0 0 0 0 0 256 256 256 256 256 256 60 0 0 0 0 0 0 0 0 0 0 0 0 0 0 0 0 0 220 256 256 256 256 256 256 256 256 256 256 256 256 256 256 155 0 0 0 0
0 0 229 256 256 256 256 229 0 0 0 0 0 0 0 0 0 0 0 152 256 256 256 256 256 256 216 69 0 0 0 0 0 113 165 207 176 116 0 0 0 0 0 0 172 256 256 256 256 256 256 256 256 256 256 256 256 256 256 256 99 0 0 0
0 0 64 242 256 256 256 246 126 0 0 0 0 0 0 0 0 0 173 242 130 237 256 256 246 104 186 256 215 66 0 0 233 256 256 256 256 256 252 187 0 0 0 0 0 235 256 256 256 256 256 256 256 256 256 256 256 256 256 256 245 0 0 0
0 0 0 0 96 96 0 129 246 220 61 57 154 165 92 0 0 132 251 68 0 0 93 99 0 0 0 59 182 255 174 248 256 256 256 256 256 256 256 256 237 83 0 0 0 0 126 155 153 148 155 153 156 224 256 256 256 256 256 256 256 185 0 0
0 0 0 0 0 0 0 0 0 191 256 256 256 256 256 197 87 253 107 0 0 0 0 0 0 0 0 0 0 103 256 256 256 256 256 256 256 256 256 256 256 252 0 0 0 0 0 0 0 0 0 0 0 0 112 250 256 256 256 256 256 254 0 0
0 0 0 0 0 0 0 0 0 0 233 256 256 256 256 256 256 181 0 0 0 0 0 0 0 0 0 0 0 141 256 256 256 256 256 256 256 256 256 256 256 256 134 0 0 0 0 0 0 0 0 0 0 0 0 125 256 256 256 256 256 247 0 0
0 0 0 0 0 0 0 0 0 0 256 256 256 256 256 256 256 0 0 0 0 0 0 0 0 0 0 0 0 225 256 256 256 256 256 256 256 256 256 256 256 256 165 0 0 0 0 0 0 0 0 0 0 0 0 0 211 256 256 256 256 150 0 0
0 0 0 0 0 0 0 0 0 67 256 256 256 256 256 256 256 0 0 0 0 0 0 0 0 0 0 0 59 256 256 256 256 256 256 256 256 256 256 256 256 256 204 0 0 0 0 0 0 0 0 0 0 0 0 0 0 185 254 246 150 0 0 0
0 0 0 0 0 100 144 144 144 179 256 256 256 256 256 256 256 151 144 144 144 144 144 144 144 144 144 144 177 256 256 256 256 256 256 256 256 256 256 256 256 256 197 0 0 0 0 0 0 0 0 0 0 0 0 0 0 0 231 127 0 0 0 0
0 0 0 0 0 224 232 208 208 226 256 256 256 256 256 256 256 214 208 208 208 208 208 208 208 208 208 208 235 256 256 256 256 256 256 256 256 256 256 256 256 256 195 0 0 0 0 0 0 0 0 0 0 0 0 0 0 0 256 67 0 0 0 0
0 0 0 0 0 224 128 0 0 82 256 256 256 256 256 256 256 0 0 0 0 0 0 0 0 0 0 0 112 256 256 256 256 256 256 256 256 256 256 256 256 256 160 0 0 0 0 0 0 0 0 0 0 0 0 0 0 129 235 0 0 0 0 0
0 0 0 0 0 224 128 0 0 0 256 256 256 256 256 256 251 0 0 0 0 0 0 0 0 0 0 0 0 253 256 256 256 256 256 256 256 256 256 256 256 256 115 0 0 0 0 0 0 0 0 0 0 0 0 0 0 215 148 0 0 0 0 0
0 0 0 0 0 224 128 0 0 0 192 256 256 256 256 256 148 0 0 0 0 0 0 0 0 0 0 0 0 171 256 256 256 256 256 256 256 256 256 256 256 234 0 0 0 0 0 0 0 0 0 0 0 0 0 0 0 244 113 0 0 0 0 0
0 0 0 0 0 224 128 0 0 0 0 153 229 236 225 249 221 64 0 0 0 0 0 0 0 0 0 0 0 0 180 256 256 256 256 256 256 256 256 256 256 118 0 0 0 0 0 0 0 0 0 0 0 0 0 0 116 249 0 0 0 0 0 0
0 0 0 0 0 224 128 0 0 0 0 0 0 0 0 0 182 255 159 0 0 0 0 0 0 0 0 0 0 0 151 256 225 256 256 256 256 256 256 234 118 0 0 0 0 0 0 0 0 0 0 0 0 0 195 256 256 224 0 0 0 0 0 0
0 0 0 0 0 224 128 0 0 0 0 0 0 0 0 0 0 94 227 241 98 0 0 0 0 0 0 0 0 88 255 103 0 54 120 189 237 234 115 0 0 0 0 0 0 0 0 0 0 0 0 0 64 232 256 256 256 256 170 0 0 0 0 0
0 0 0 0 0 224 128 0 0 0 0 0 0 0 0 0 0 0 0 145 256 124 0 0 0 0 0 0 153 256 155 0 0 0 0 0 107 247 0 0 0 0 0 0 0 0 0 0 0 0 0 0 242 256 256 256 256 256 253 0 0 0 0 0
0 0 0 0 110 244 191 0 0 0 0 0 0 0 0 0 0 0 0 0 123 252 0 0 0 0 60 223 242 86 0 0 0 0 0 0 0 255 80 0 0 0 0 0 0 0 0 0 0 0 0 97 256 256 256 256 256 256 255 0 0 0 0 0
0 0 0 188 256 256 256 241 0 0 0 0 0 0 0 0 0 0 0 0 0 212 218 183 166 138 252 184 0 0 0 0 0 0 0 0 0 233 118 0 0 0 0 0 0 0 0 0 0 0 0 192 256 256 256 256 256 256 187 0 0 0 0 0
0 0 81 256 256 256 256 256 177 0 0 0 0 0 0 0 0 0 0 0 0 176 256 256 256 256 165 0 0 0 0 0 0 0 0 0 0 210 182 0 0 0 0 0 0 0 0 0 0 0 0 252 256 256 256 256 256 209 0 0 0 0 0 0
0 0 126 256 256 256 256 256 224 0 0 0 0 0 0 0 0 0 0 0 64 256 256 256 256 256 214 0 0 0 0 0 0 0 0 0 172 256 256 256 145 0 0 0 0 0 0 0 0 0 91 256 256 256 256 256 256 62 0 0 0 0 0 0
0 0 128 256 256 256 256 256 256 256 256 256 256 256 256 256 256 256 256 256 256 256 256 256 256 256 252 0 0 0 0 0 0 0 0 113 256 256 256 256 256 92 0 0 0 90 119 128 128 128 169 256 256 256 256 256 245 0 0 0 0 0 0 0
0 0 127 256 256 256 256 256 233 80 80 80 80 80 80 80 80 80 80 80 99 256 256 256 256 256 204 0 0 0 0 0 0 0 0 184 256 256 256 256 256 256 256 256 256 256 238 224 224 224 232 256 256 256 256 256 256 0 0 0 0 0 0 0
0 0 95 256 256 256 256 256 191 0 0 0 0 0 0 0 0 0 0 0 0 145 256 256 256 246 59 0 0 0 0 0 0 0 0 167 256 256 256 256 256 157 64 64 64 0 0 0 0 0 0 256 256 256 256 256 256 76 0 0 0 0 0 0
0 0 0 218 256 256 256 253 72 0 0 0 0 0 0 0 0 0 0 0 0 0 81 151 134 0 0 0 0 0 0 0 0 0 0 63 253 256 256 256 246 0 0 0 0 0 0 0 0 0 0 230 256 256 256 256 256 0 0 0 0 0 0 0
0 0 0 0 158 219 190 72 0 0 0 0 0 0 0 0 0 0 0 0 0 0 0 0 0 0 0 0 0 0 0 0 0 0 0 0 79 213 252 203 59 0 0 0 0 0 0 0 0 0 0 93 255 256 256 256 156 0 0 0 0 0 0 0
0 0 0 0 0 0 0 0 0 0 0 0 0 0 0 0 0 0 0 0 0 0 0 0 0 0 0 0 0 0 0 0 0 0 0 0 0 0 0 0 0 0 0 0 0 0 0 0 0 0 0 0 71 170 181 105 0 0 0 0 0 0 0 0
0 0 0 0 0 0 0 0 0 0 0 0 0 0 0 0 0 0 0 0 0 0 0 0 0 0 0 0 0 0 0 0 0 0 0 0 0 0 0 0 0 0 0 0 0 0 0 0 0 0 0 0 0 0 0 0 0 0 0 0 0 0 0 0