0 0 0 0 0 0 0 0 0 0 0 0 0 0 0 0 0 0 0 0 0 0 0 0 0 0 0 0 0 0 0 0 0 0 0 0 0 0 0 0 0 0 0 0 0 0 0 0 0 0 0 0 0 0 0 0 0 0 0 0 0 0 0 0
0 0 0 35 58 59 38 0 0 0 0 0 0 0 0 0 0 0 0 0 0 34 57 60 39 0 0 0 0 0 0 0 0 0 0 0 0 0 0 0 0 0 0 0 0 15 41 48 48 48 48 48 44 45 30 0 0 0 0 0 0 0 0 0
0 0 39 64 64 64 64 45 0 0 0 0 0 0 0 0 0 0 0 0 37 64 64 64 64 64 64 64 64 64 64 64 64 64 64 64 64 64 64 64 64 64 64 64 64 64 64 64 64 64 64 64 64 64 64 64 45 0 0 0 0 0 0 0
0 0 63 64 64 64 64 64 0 0 0 0 0 0 0 0 0 0 0 0 62 64 64 64 64 64 33 24 27 26 24 24 24 24 24 24 24 24 24 24 24 24 24 24 52 64 64 64 64 64 64 64 64 64 64 64 64 63 32 0 0 0 0 0
0 0 64 64 64 64 64 64 13 0 0 0 0 0 0 0 0 0 0 0 64 64 64 64 64 64 17 0 0 0 0 0 0 0 0 0 0 0 0 0 0 0 0 0 54 64 64 64 64 64 64 64 64 64 64 64 64 64 64 42 0 0 0 0
0 0 55 64 64 64 64 58 0 0 0 0 0 0 0 0 0 0 0 38 64 64 64 64 64 64 56 21 0 0 0 0 0 29 43 55 46 30 0 0 0 0 0 0 41 64 64 64 64 64 64 64 64 64 64 64 64 64 64 64 27 0 0 0
0 0 14 59 64 64 64 63 33 0 0 0 0 0 0 0 0 0 43 61 30 57 64 64 61 26 44 64 56 20 0 0 58 64 64 64 64 64 64 50 0 0 0 0 0 58 64 64 64 64 64 64 64 64 64 64 64 64 64 64 62 0 0 0
0 0 0 0 21 22 0 29 60 57 18 15 40 44 27 0 0 33 63 16 0 0 21 22 0 0 0 0 43 64 46 62 64 64 64 64 64 64 64 64 61 25 0 0 0 0 29 38 36 34 38 36 37 54 64 64 64 64 64 64 64 50 0 0
0 0 0 0 0 0 0 0 0 45 64 64 64 64 64 53 24 63 27 0 0 0 0 0 0 0 0 0 0 23 64 64 64 64 64 64 64 64 64 64 64 64 14 0 0 0 0 0 0 0 0 0 0 0 25 61 64 64 64 64 64 64 0 0
0 0 0 0 0 0 0 0 0 0 56 64 64 64 64 64 64 46 0 0 0 0 0 0 0 0 0 0 0 34 64 64 64 64 64 64 64 64 64 64 64 64 37 0 0 0 0 0 0 0 0 0 0 0 0 27 64 64 64 64 64 62 0 0
0 0 0 0 0 0 0 0 0 0 64 64 64 64 64 64 64 0 0 0 0 0 0 0 0 0 0 0 0 55 64 64 64 64 64 64 64 64 64 64 64 64 44 0 0 0 0 0 0 0 0 0 0 0 0 0 50 64 64 64 64 38 0 0
0 0 0 0 0 0 0 0 0 15 64 64 64 64 64 64 64 0 0 0 0 0 0 0 0 0 0 0 13 64 64 64 64 64 64 64 64 64 64 64 64 64 54 0 0 0 0 0 0 0 0 0 0 0 0 0 0 43 63 61 36 0 0 0
0 0 0 0 0 27 40 40 40 46 64 64 64 64 64 64 64 43 40 40 40 40 40 40 40 40 40 40 45 64 64 64 64 64 64 64 64 64 64 64 64 64 51 0 0 0 0 0 0 0 0 0 0 0 0 0 0 0 57 32 0 0 0 0
0 0 0 0 0 56 56 48 48 54 64 64 64 64 64 64 64 50 48 48 48 48 48 48 48 48 48 48 56 64 64 64 64 64 64 64 64 64 64 64 64 64 51 0 0 0 0 0 0 0 0 0 0 0 0 0 0 0 64 17 0 0 0 0
0 0 0 0 0 56 32 0 0 17 64 64 64 64 64 64 64 0 0 0 0 0 0 0 0 0 0 0 25 64 64 64 64 64 64 64 64 64 64 64 64 64 40 0 0 0 0 0 0 0 0 0 0 0 0 0 0 31 60 0 0 0 0 0
0 0 0 0 0 56 32 0 0 0 64 64 64 64 64 64 63 0 0 0 0 0 0 0 0 0 0 0 0 62 64 64 64 64 64 64 64 64 64 64 64 64 30 0 0 0 0 0 0 0 0 0 0 0 0 0 0 53 38 0 0 0 0 0
0 0 0 0 0 56 32 0 0 0 45 64 64 64 64 64 38 0 0 0 0 0 0 0 0 0 0 0 0 39 64 64 64 64 64 64 64 64 64 64 64 59 0 0 0 0 0 0 0 0 0 0 0 0 0 0 0 61 29 0 0 0 0 0
0 0 0 0 0 56 32 0 0 0 0 35 54 56 54 61 57 19 0 0 0 0 0 0 0 0 0 0 0 0 43 64 64 64 64 64 64 64 64 64 64 30 0 0 0 0 0 0 0 0 0 0 0 0 0 0 28 63 0 0 0 0 0 0
0 0 0 0 0 56 32 0 0 0 0 0 0 0 0 0 43 64 42 0 0 0 0 0 0 0 0 0 0 0 38 64 55 64 64 64 64 64 64 58 29 0 0 0 0 0 0 0 0 0 0 0 0 0 49 64 64 57 0 0 0 0 0 0
0 0 0 0 0 56 32 0 0 0 0 0 0 0 0 0 0 21 55 61 28 0 0 0 0 0 0 0 0 22 64 26 0 0 27 45 57 60 27 0 0 0 0 0 0 0 0 0 0 0 0 0 15 58 64 64 64 64 46 0 0 0 0 0
0 0 0 0 0 56 32 0 0 0 0 0 0 0 0 0 0 0 0 34 64 34 0 0 0 0 0 0 39 64 40 0 0 0 0 0 24 63 0 0 0 0 0 0 0 0 0 0 0 0 0 0 60 64 64 64 64 64 64 0 0 0 0 0
0 0 0 0 30 61 49 0 0 0 0 0 0 0 0 0 0 0 0 0 26 64 13 0 0 0 16 56 60 21 0 0 0 0 0 0 0 63 22 0 0 0 0 0 0 0 0 0 0 0 0 23 64 64 64 64 64 64 64 0 0 0 0 0
0 0 0 48 64 64 64 61 13 0 0 0 0 0 0 0 0 0 0 0 0 50 56 47 44 36 63 46 0 0 0 0 0 0 0 0 0 56 32 0 0 0 0 0 0 0 0 0 0 0 0 46 64 64 64 64 64 64 48 0 0 0 0 0
0 0 19 64 64 64 64 64 47 0 0 0 0 0 0 0 0 0 0 0 0 43 64 64 64 64 42 0 0 0 0 0 0 0 0 0 0 51 48 13 0 0 0 0 0 0 0 0 0 0 0 63 64 64 64 64 64 53 0 0 0 0 0 0
0 0 31 64 64 64 64 64 57 0 0 0 0 0 0 0 0 0 0 0 16 64 64 64 64 64 57 0 0 0 0 0 0 0 0 0 42 64 64 64 41 0 0 0 0 0 0 0 0 0 22 64 64 64 64 64 64 16 0 0 0 0 0 0
0 0 32 64 64 64 64 64 64 64 64 64 64 64 64 64 64 64 64 64 64 64 64 64 64 64 64 0 0 0 0 0 0 0 0 27 64 64 64 64 64 26 0 0 0 23 30 32 32 32 40 64 64 64 64 64 64 0 0 0 0 0 0 0
0 0 31 64 64 64 64 64 58 16 16 16 16 16 16 16 16 16 16 16 21 64 64 64 64 64 52 0 0 0 0 0 0 0 0 45 64 64 64 64 64 64 64 64 64 64 59 56 56 56 58 64 64 64 64 64 64 0 0 0 0 0 0 0
0 0 21 64 64 64 64 64 49 0 0 0 0 0 0 0 0 0 0 0 0 34 64 64 64 61 14 0 0 0 0 0 0 0 0 39 64 64 64 64 64 40 16 16 16 0 0 0 0 0 0 64 64 64 64 64 64 22 0 0 0 0 0 0
0 0 0 53 64 64 64 63 18 0 0 0 0 0 0 0 0 0 0 0 0 0 18 36 32 0 0 0 0 0 0 0 0 0 0 14 63 64 64 64 61 0 0 0 0 0 0 0 0 0 0 55 64 64 64 64 64 0 0 0 0 0 0 0
0 0 0 0 38 53 46 17 0 0 0 0 0 0 0 0 0 0 0 0 0 0 0 0 0 0 0 0 0 0 0 0 0 0 0 0 18 51 62 49 14 0 0 0 0 0 0 0 0 0 0 19 63 64 64 64 41 0 0 0 0 0 0 0
0 0 0 0 0 0 0 0 0 0 0 0 0 0 0 0 0 0 0 0 0 0 0 0 0 0 0 0 0 0 0 0 0 0 0 0 0 0 0 0 0 0 0 0 0 0 0 0 0 0 0 0 15 40 44 26 0 0 0 0 0 0 0 0
15 0 0 0 0 0 0 0 0 0 0 0 0 0 0 0 0 0 0 0 0 0 0 0 0 0 0 0 0 0 0 0 0 0 0 0 0 0 0 0 0 0 0 0 0 0 0 0 0 0 0 0 0 0 0 0 0 0 0 0 0 0 0 0