0 0 117 0 0 0 0 0 0 0 0 117 0 0 0 0 0 0 0 0 0 0 0 89 96 96 89 0 0 0 0 0
0 230 256 237 0 0 0 0 0 0 227 256 256 185 181 176 176 176 176 176 176 176 244 256 256 256 256 256 184 0 0 0
0 247 256 250 0 0 0 0 0 0 256 256 256 94 0 0 0 98 76 0 0 0 223 256 256 256 256 256 256 234 0 0
0 77 171 162 154 0 84 0 0 183 90 171 93 120 183 119 250 256 256 242 98 0 71 195 198 202 219 256 256 256 186 0
0 0 0 0 0 248 256 245 197 0 0 0 0 0 57 256 256 256 256 256 256 0 0 0 0 0 0 113 256 256 254 0
0 0 0 0 0 256 256 256 142 0 0 0 0 0 132 256 256 256 256 256 256 98 0 0 0 0 0 0 163 252 139 0
0 0 83 184 188 256 256 256 221 176 176 176 176 176 229 256 256 256 256 256 256 102 0 0 0 0 0 0 0 170 0 0
0 0 112 64 0 256 256 256 139 0 0 0 0 0 154 256 256 256 256 256 256 70 0 0 0 0 0 0 84 99 0 0
0 0 112 64 0 147 238 243 114 0 0 0 0 0 0 235 256 256 256 256 217 0 0 0 0 0 0 0 155 0 0 0
0 0 112 64 0 0 0 0 128 166 0 0 0 0 0 192 130 200 245 153 0 0 0 0 0 0 80 241 249 52 0 0
0 0 147 92 0 0 0 0 0 0 188 0 0 75 184 0 0 0 154 0 0 0 0 0 0 0 252 256 256 138 0 0
0 132 256 253 60 0 0 0 0 0 94 231 208 151 0 0 0 0 107 93 0 0 0 0 0 116 256 256 245 54 0 0
0 191 256 256 193 144 144 144 144 144 208 256 256 121 0 0 0 0 234 256 131 0 0 62 64 190 256 256 144 0 0 0
0 180 256 256 123 0 0 0 0 0 119 256 253 66 0 0 0 84 256 256 232 160 147 115 112 191 256 256 159 0 0 0
0 60 219 190 0 0 0 0 0 0 0 54 0 0 0 0 0 0 196 239 85 0 0 0 0 74 255 256 116 0 0 0
0 0 0 0 0 0 0 0 0 0 0 0 0 0 0 0 0 0 0 0 0 0 0 0 0 0 71 86 0 0 0 0