0 0 0 0 0 0 0 0 0 0 0 0 0 0 0 0 0 0 0 0 0 0 0 0 0 0 0 0 0 0 0 0
0 0 0 169 177 176 176 176 167 173 176 220 210 176 182 201 179 172 174 160 157 144 140 128 122 112 105 96 88 0 0 0
0 0 0 194 177 104 0 0 0 0 172 235 240 84 125 240 156 0 0 67 245 74 102 126 74 172 77 190 113 128 0 0
0 0 0 176 0 100 178 0 104 177 54 200 150 187 176 176 123 91 0 186 141 0 80 96 0 144 0 160 0 128 0 0
0 0 0 168 0 0 60 236 101 0 121 100 144 117 74 176 0 176 182 0 128 0 80 96 0 144 0 160 0 128 0 0
0 0 0 176 0 113 170 0 0 0 185 0 144 112 64 176 0 125 203 0 128 178 190 196 172 144 0 179 0 128 0 0
0 0 0 189 181 92 0 0 0 81 106 0 138 112 64 176 60 157 72 144 128 61 91 106 0 144 170 174 100 128 0 0
0 0 0 208 111 0 0 0 0 177 0 0 128 112 64 188 185 0 0 137 201 0 80 96 0 226 112 0 214 128 0 0
0 0 0 201 148 98 0 0 64 145 0 0 208 202 184 238 194 160 160 165 254 178 190 196 172 253 162 160 221 128 0 0
0 0 0 192 0 207 144 144 156 136 0 0 136 121 76 198 186 0 0 110 235 61 91 106 0 245 92 0 216 128 0 0
0 0 0 192 181 0 0 0 0 155 56 0 128 112 64 176 55 175 100 148 129 0 80 96 0 149 177 181 96 128 0 0
0 0 0 192 176 0 0 0 0 0 186 56 128 124 72 176 0 130 227 0 128 191 201 206 186 144 54 140 0 128 0 0
0 0 0 174 56 131 180 153 78 0 69 187 151 185 184 184 91 148 63 173 134 0 80 96 0 144 0 128 0 128 0 0
0 0 0 171 0 0 0 76 152 218 181 223 250 92 114 249 198 65 64 130 246 100 124 136 88 172 100 160 100 128 0 0
0 0 0 77 128 128 128 128 128 128 128 129 136 128 128 121 112 112 112 112 112 112 112 112 112 112 112 115 112 0 0 0
0 0 0 0 0 0 0 0 0 0 0 0 0 0 0 0 0 0 0 0 0 0 0 0 0 0 0 0 0 0 0 0