0 0 0 0 0 0 0 0 0 0 0 0 0 0 0 0 0 0 0 0 0 0 0 0 0 0 0 0 0 0 0 0 0 0 0 0 0 0 0 0 0 0 0 0 0 0 0 0 0 0 0 0 0 0 0 0 0 0 0 0 0 0 0 0
0 0 0 0 0 0 0 0 0 0 0 0 0 0 0 0 0 0 0 0 0 0 0 0 0 0 0 0 0 0 0 0 0 0 0 0 0 0 0 0 0 0 0 0 0 0 0 0 0 0 0 0 0 0 0 0 0 0 0 0 0 0 0 0
0 0 0 0 0 0 20 32 32 34 40 40 40 40 40 40 40 40 45 48 48 48 48 48 42 40 40 40 40 40 40 33 32 31 24 24 24 22 16 16 16 13 0 0 0 0 0 0 0 0 0 0 0 0 0 0 0 0 0 0 0 0 0 0
0 0 0 0 0 0 53 64 63 48 48 48 48 48 48 48 47 40 40 40 40 40 60 64 64 64 48 48 48 54 64 64 60 56 60 64 64 64 64 64 64 64 64 64 64 64 64 64 64 58 56 56 56 49 48 48 48 40 32 0 0 0 0 0
0 0 0 0 0 0 48 58 63 49 0 0 0 0 0 0 0 0 0 0 0 48 64 64 64 64 23 0 0 45 64 64 53 0 0 0 0 0 0 14 61 64 34 16 16 46 54 24 24 34 64 36 32 37 64 46 40 49 64 0 0 0 0 0
0 0 0 0 0 0 48 40 13 52 62 32 0 0 0 0 0 0 0 28 62 54 43 64 64 48 58 0 16 64 57 55 60 40 0 0 0 0 0 47 56 64 24 0 0 40 48 0 0 16 64 0 0 0 64 16 0 24 64 0 0 0 0 0
0 0 0 0 0 0 48 40 0 0 29 62 53 14 0 0 0 0 50 63 32 0 56 53 64 14 60 34 51 48 40 48 21 64 22 0 0 0 32 63 13 64 24 0 0 40 48 0 0 16 64 0 0 0 64 16 0 24 64 0 0 0 0 0
0 0 0 0 0 0 48 40 0 0 0 0 48 63 35 0 32 62 52 0 0 20 64 27 64 0 29 64 64 13 40 48 0 38 61 0 0 17 63 28 0 64 24 0 0 40 48 0 0 16 64 0 0 0 64 16 0 24 64 0 0 0 0 0
0 0 0 0 0 0 47 40 0 0 0 0 0 25 60 63 62 29 0 0 0 47 47 16 64 0 0 59 42 0 40 48 0 0 53 51 0 59 43 0 0 64 24 0 0 40 48 0 0 16 64 0 0 0 64 16 0 24 64 0 0 0 0 0
0 0 0 0 0 0 40 41 0 0 0 0 0 33 63 50 0 0 0 0 0 64 21 16 64 0 0 56 32 0 40 48 0 0 0 61 61 55 0 0 0 64 24 0 0 40 48 0 0 16 64 0 0 0 64 16 0 24 64 0 0 0 0 0
0 0 0 0 0 0 40 48 0 0 0 14 54 61 27 0 0 0 0 0 37 57 0 16 64 0 0 56 32 0 40 48 0 0 0 42 64 26 0 0 0 64 34 16 16 46 52 16 16 28 64 0 0 0 64 16 0 24 64 0 0 0 0 0
0 0 0 0 0 0 40 48 0 0 36 63 47 0 0 0 0 0 0 0 61 30 0 16 64 0 0 56 32 0 40 48 0 0 19 64 54 59 0 0 0 64 64 64 64 64 64 64 64 64 64 0 0 27 64 35 0 24 64 0 0 0 0 0
0 0 0 0 0 0 40 48 16 56 60 25 0 0 0 0 0 0 0 27 62 0 0 16 64 0 0 56 32 0 40 48 0 0 59 41 0 56 48 0 0 64 29 0 0 43 50 0 0 22 64 0 0 61 54 62 0 24 64 0 0 0 0 0
0 0 0 0 0 0 40 61 64 45 0 0 0 0 0 0 0 0 0 54 39 0 0 16 64 0 0 56 32 0 40 48 0 51 54 0 0 13 63 32 0 64 24 0 0 40 48 0 0 16 64 0 47 54 0 55 43 24 64 0 0 0 0 0
0 0 0 0 0 0 40 64 35 0 0 0 0 0 0 0 0 0 18 64 0 0 0 16 64 0 0 56 32 0 40 48 36 61 0 0 0 0 28 63 16 64 24 0 0 40 48 0 0 16 64 35 63 14 0 20 64 40 64 0 0 0 0 0
0 0 0 0 0 0 40 64 61 15 0 0 0 0 0 0 0 0 45 50 0 0 0 16 64 0 0 56 32 0 40 60 64 24 0 0 0 0 0 46 57 64 24 0 0 40 48 0 0 16 64 63 35 0 0 0 47 63 64 0 0 0 0 0
0 0 0 0 0 0 40 64 43 61 15 0 0 0 0 0 0 0 63 22 0 0 0 16 64 16 16 58 40 16 46 64 50 16 16 16 16 16 16 21 62 64 34 16 16 46 52 16 16 28 64 61 18 16 16 16 29 64 64 0 0 0 0 0
0 0 0 0 0 0 33 64 0 43 61 22 16 16 16 16 16 40 58 0 0 0 0 16 64 64 64 64 64 64 64 64 64 64 64 64 64 64 64 64 64 64 64 64 64 64 64 64 64 64 64 64 64 64 64 64 64 64 64 0 0 0 0 0
0 0 0 0 0 0 32 64 0 0 55 64 64 64 64 64 64 64 48 0 0 0 0 20 64 0 0 57 36 0 43 64 61 18 0 0 0 0 0 24 64 64 29 0 0 43 50 0 0 22 64 63 21 0 0 0 37 64 64 0 0 0 0 0
0 0 0 0 0 0 32 64 0 26 64 24 0 0 0 0 0 20 64 24 0 0 0 24 64 0 0 56 32 0 40 51 49 58 0 0 0 0 16 62 43 64 24 0 0 40 48 0 0 16 64 54 57 0 0 16 63 52 64 0 0 0 0 0
0 0 0 0 0 0 32 64 15 63 33 0 0 0 0 0 0 0 37 60 0 0 0 24 64 0 0 56 32 0 40 48 0 49 58 0 0 15 61 43 0 64 24 0 0 40 48 0 0 16 64 13 56 48 0 58 44 24 64 0 0 0 0 0
0 0 0 0 0 0 32 64 58 45 0 0 0 0 0 0 0 0 0 55 48 0 0 24 64 0 0 56 32 0 40 48 0 0 49 58 24 61 43 0 0 64 24 0 0 40 48 0 0 16 64 0 0 61 61 55 0 24 64 0 0 0 0 0
0 0 0 0 0 0 32 64 56 0 0 0 0 0 0 0 0 0 0 14 63 27 0 24 64 0 0 56 32 0 40 48 0 0 0 51 64 45 0 0 0 64 54 48 48 58 60 48 48 52 64 0 0 30 64 0 0 24 64 0 0 0 0 0
0 0 0 0 0 0 32 64 64 53 34 15 0 0 0 0 0 0 0 0 35 61 0 24 64 0 0 61 40 0 40 48 0 0 15 61 60 58 0 0 0 64 49 40 40 55 58 40 40 46 64 0 0 24 64 0 0 24 64 0 0 0 0 0
0 0 0 0 0 0 32 57 18 38 56 64 59 41 22 0 0 0 0 0 0 54 48 25 64 0 45 60 64 20 40 48 0 15 61 43 0 53 58 0 0 64 24 0 0 40 48 0 0 16 64 0 0 24 64 0 0 24 64 0 0 0 0 0
0 0 0 0 0 0 29 56 0 0 0 0 31 49 64 63 48 30 0 0 0 13 63 51 64 23 64 16 40 60 48 48 15 61 43 0 0 0 54 54 0 64 24 0 0 40 48 0 0 16 64 0 0 24 64 0 0 24 64 0 0 0 0 0
0 0 0 0 0 0 24 59 0 0 0 0 0 0 0 23 42 61 64 55 36 17 33 64 64 59 40 0 0 53 64 57 61 43 0 0 0 0 0 54 54 64 24 0 0 40 48 0 0 16 64 0 0 24 64 0 0 24 64 0 0 0 0 0
0 0 0 0 0 0 24 64 24 24 24 24 24 24 24 24 24 25 40 59 64 64 62 64 64 63 28 24 24 34 64 64 61 33 32 32 32 32 32 38 64 64 44 32 32 52 56 32 32 40 64 36 32 44 64 32 32 44 64 0 0 0 0 0
0 0 0 0 0 0 15 62 64 64 64 64 64 64 64 64 64 64 64 64 64 64 64 64 64 64 64 64 64 64 64 57 56 56 56 56 56 56 56 56 56 56 56 56 56 56 56 56 56 56 56 56 56 56 59 56 56 56 45 0 0 0 0 0
0 0 0 0 0 0 0 0 0 0 0 0 0 0 0 0 0 0 0 0 0 0 0 0 0 0 0 0 0 0 0 0 0 0 0 0 0 0 0 0 0 0 0 0 0 0 0 0 0 0 0 0 0 0 0 0 0 0 0 0 0 0 0 0
0 0 0 0 0 0 0 0 0 0 0 0 0 0 0 0 0 0 0 0 0 0 0 0 0 0 0 0 0 0 0 0 0 0 0 0 0 0 0 0 0 0 0 0 0 0 0 0 0 0 0 0 0 0 0 0 0 0 0 0 0 0 0 0
15 0 0 0 0 0 0 0 0 0 0 0 0 0 0 0 0 0 0 0 0 0 0 0 0 0 0 0 0 0 0 0 0 0 0 0 0 0 0 0 0 0 0 0 0 0 0 0 0 0 0 0 0 0 0 0 0 0 0 0 0 0 0 0