0 0 0 0 0 0 0 0 0 0 0 0 0 0 0 0 0 0 0 0 0 0 0 0 0 0 0 0 0 0 0 0 0 0 0 0 0 0 0 0 0 0 0 0 0 0 0 0 0 0 0 0 0 0 0 0 0 0 0 0 0 0 0 0
0 0 0 0 0 0 0 0 0 0 0 0 0 0 0 0 0 0 0 0 0 0 0 0 0 0 0 0 0 0 0 0 0 0 0 0 0 0 0 0 0 0 0 0 0 0 0 0 0 0 0 0 0 0 0 0 0 0 0 0 0 0 0 0
0 0 0 0 0 0 0 0 0 0 0 0 0 0 0 0 0 0 0 0 0 0 0 0 0 0 0 0 0 0 0 0 0 0 0 0 0 0 0 0 0 0 0 0 0 0 0 0 0 0 0 0 0 0 0 0 0 0 0 0 0 0 0 0
0 0 0 0 0 0 0 251 256 256 256 256 252 249 256 256 256 253 248 254 231 256 255 254 256 240 256 256 256 256 240 163 179 228 240 240 240 231 228 240 240 238 233 240 240 231 231 240 240 240 227 240 240 232 236 240 240 231 181 0 0 0 0 0
0 0 0 0 0 0 0 234 0 0 0 0 0 0 0 0 0 0 156 229 150 242 242 0 0 0 0 0 0 0 0 0 0 0 0 0 0 0 0 156 176 184 142 0 0 163 173 0 0 157 256 0 0 146 188 0 0 150 231 0 0 0 0 0
0 0 0 0 0 0 0 229 0 0 0 0 0 0 0 0 179 247 256 210 133 0 0 140 192 0 0 0 0 0 0 162 0 0 0 0 0 0 0 0 0 228 0 0 0 160 192 0 0 0 256 0 0 0 256 0 0 0 240 0 0 0 0 0
0 0 0 0 0 0 0 213 0 0 0 0 129 207 256 248 182 0 0 0 0 0 0 150 256 0 0 0 0 0 179 192 0 0 0 0 0 0 0 0 0 256 0 0 0 160 192 0 0 0 256 0 0 0 256 0 0 0 240 0 0 0 0 0
0 0 0 0 0 0 128 229 0 160 233 256 228 154 0 0 0 0 0 0 0 0 0 0 256 0 0 0 0 0 160 192 0 0 156 0 0 0 0 0 0 256 0 0 0 160 192 0 0 0 256 0 0 0 256 0 0 0 240 0 0 0 0 0
0 0 0 0 0 0 0 149 206 202 0 0 0 0 0 0 0 0 0 0 0 145 0 0 248 0 0 141 0 0 160 192 0 0 0 0 0 0 0 0 0 256 190 160 160 156 152 160 160 189 256 0 0 0 256 0 0 0 240 0 0 0 0 0
0 0 0 0 0 0 128 212 0 0 0 0 0 0 0 0 0 0 0 0 0 0 0 0 256 0 0 240 0 0 160 192 0 0 0 0 0 147 0 0 0 256 212 192 192 152 140 192 192 211 256 0 0 0 0 0 0 0 240 0 0 0 0 0
0 0 0 0 0 0 128 214 0 0 0 0 0 0 0 0 0 0 0 0 0 0 0 0 251 0 0 240 0 0 160 192 0 0 0 0 0 0 0 0 0 256 0 0 0 160 192 0 0 0 256 0 0 0 0 0 0 0 240 0 0 0 0 0
0 0 0 0 0 0 144 240 0 0 0 0 0 0 0 0 0 0 0 0 0 0 0 0 256 0 0 240 0 0 160 192 0 0 0 0 0 0 0 0 0 256 0 0 0 160 192 0 0 0 256 0 0 0 0 0 0 0 240 0 0 0 0 0
0 0 0 0 0 0 137 238 0 0 0 0 0 0 0 0 0 0 152 0 0 0 0 0 256 0 0 240 0 0 160 206 0 0 0 0 0 0 0 0 0 256 0 0 0 160 192 0 0 0 191 0 0 0 0 0 0 130 234 0 0 0 0 0
0 0 0 0 0 0 144 240 0 0 0 157 256 256 256 256 256 161 156 0 0 0 0 0 256 0 0 242 130 0 172 0 0 0 0 0 0 0 0 0 0 237 0 0 0 170 194 0 0 0 179 0 0 0 0 0 0 0 234 0 0 0 0 0
0 0 0 0 0 0 139 238 0 0 0 0 0 0 0 0 0 0 0 0 0 0 0 0 162 256 256 0 176 256 128 0 164 256 256 256 256 256 256 256 0 0 235 256 256 128 0 256 256 256 184 0 256 256 256 256 249 0 240 0 0 0 0 0
0 0 0 0 0 0 160 243 0 0 0 0 0 0 0 0 0 0 206 0 0 0 0 0 240 0 0 218 138 0 168 0 0 0 0 0 0 0 0 0 0 193 0 0 0 170 194 0 0 0 194 0 0 0 0 0 0 0 240 0 0 0 0 0
0 0 0 0 0 0 160 160 0 0 0 0 0 0 0 0 0 0 0 0 0 0 0 0 256 0 0 240 0 0 160 152 0 0 0 0 0 0 0 0 0 231 0 0 0 160 192 0 0 0 176 0 0 0 0 0 192 133 228 0 0 0 0 0
0 0 0 0 0 0 152 0 0 0 0 0 0 0 0 0 0 0 0 223 0 0 0 0 256 0 0 240 0 0 160 192 0 0 0 0 0 0 0 0 0 256 0 0 0 160 192 0 0 0 216 0 0 0 0 0 132 163 240 0 0 0 0 0
0 0 0 0 0 0 163 176 252 172 0 0 0 0 0 0 0 0 0 182 0 0 0 0 256 0 0 240 0 0 160 192 0 0 0 0 0 0 0 0 0 256 0 0 0 160 192 0 0 0 216 0 0 0 0 0 0 0 240 0 0 0 0 0
0 0 0 0 0 0 167 168 0 219 236 0 0 0 0 0 0 0 0 0 203 0 0 0 256 0 0 240 0 0 160 192 0 0 0 0 0 0 0 0 0 256 0 0 0 172 200 0 0 0 216 0 0 0 0 0 0 0 240 0 0 0 0 0
0 0 0 0 0 0 176 176 0 0 132 243 179 0 0 0 0 0 0 0 188 0 0 0 256 0 0 240 0 0 160 192 0 0 0 0 0 0 0 0 0 202 208 256 256 128 0 256 256 256 256 0 0 0 0 0 0 0 240 0 0 0 0 0
0 0 0 0 0 0 168 167 0 0 0 0 193 243 0 0 0 0 0 0 0 153 0 0 247 0 0 240 0 0 160 192 0 0 0 0 0 0 0 0 0 247 0 0 0 168 188 0 0 0 256 0 0 0 256 0 0 0 240 0 0 0 0 0
0 0 0 0 0 0 176 161 0 0 0 0 0 0 242 189 0 0 0 0 0 167 0 0 256 0 0 240 0 0 160 192 0 0 0 0 0 0 0 0 0 256 0 0 0 160 192 0 0 0 256 0 0 0 256 0 0 0 240 0 0 0 0 0
0 0 0 0 0 0 182 152 0 0 0 0 0 0 244 225 240 0 0 0 0 0 0 0 251 0 0 133 0 0 160 192 0 0 0 0 0 0 0 0 0 256 0 0 0 160 192 0 0 0 256 0 0 0 256 0 0 0 240 0 0 0 0 0
0 0 0 0 0 0 192 160 0 0 0 0 192 249 130 0 0 241 197 0 0 0 159 0 256 0 0 134 0 0 160 192 0 0 0 0 0 0 0 0 0 256 0 0 0 160 192 0 0 0 256 0 0 0 256 0 0 0 240 0 0 0 0 0
0 0 0 0 0 0 183 152 0 0 133 246 184 0 0 0 0 0 187 251 0 0 156 180 256 0 148 0 131 0 160 192 0 0 0 0 0 0 0 0 0 256 0 0 0 160 192 0 0 0 256 0 0 0 256 0 0 0 240 0 0 0 0 0
0 0 0 0 0 0 192 145 0 216 243 0 0 0 0 0 0 0 0 0 245 191 175 0 216 131 0 0 0 0 196 197 0 0 0 0 0 0 0 0 0 222 0 0 0 160 192 0 0 0 256 0 0 0 256 0 0 0 240 0 0 0 0 0
0 0 0 0 0 0 193 164 217 184 0 0 0 0 0 0 0 0 0 0 0 182 191 0 0 0 0 0 0 0 0 0 0 0 0 0 0 0 0 0 0 183 0 0 0 190 184 0 0 138 225 138 137 167 256 183 176 166 229 0 0 0 0 0
0 0 0 0 0 0 224 215 160 207 208 208 200 191 190 192 188 176 176 176 176 161 157 0 216 132 208 208 208 196 169 240 231 236 245 251 250 256 255 241 204 236 248 247 255 256 228 243 240 222 223 210 198 192 191 176 175 160 0 0 0 0 0 0
0 0 0 0 0 0 0 128 128 133 144 144 144 145 158 160 160 160 168 176 176 176 181 192 152 144 144 144 144 144 144 128 0 0 0 0 0 0 0 0 0 0 0 0 0 0 0 0 0 0 0 0 0 0 0 0 0 0 0 0 0 0 0 0
0 0 0 0 0 0 0 0 0 0 0 0 0 0 0 0 0 0 0 0 0 0 0 0 0 0 0 0 0 0 0 0 0 0 0 0 0 0 0 0 0 0 0 0 0 0 0 0 0 0 0 0 0 0 0 0 0 0 0 0 0 0 0 0
0 0 0 0 0 0 0 0 0 0 0 0 0 0 0 0 0 0 0 0 0 0 0 0 0 0 0 0 0 0 0 0 0 0 0 0 0 0 0 0 0 0 0 0 0 0 0 0 0 0 0 0 0 0 0 0 0 0 0 0 0 0 0 0