0 0 0 0 0 0 0 0 0 0 0 0 0 0 0 0 0 0 0 0 0 0 0 0 0 0 0 0 0 0 0 0
0 0 0 96 128 128 128 96 0 0 0 0 0 0 0 0 0 0 0 0 0 0 0 0 0 0 0 0 64 256 224 0
0 0 0 192 256 256 256 192 0 0 0 0 0 0 0 0 0 0 0 0 0 0 0 0 0 0 0 0 64 256 224 0
0 0 0 192 256 256 256 228 144 144 144 144 144 184 152 144 144 144 144 144 144 176 148 144 144 228 100 134 112 256 224 0
0 0 0 192 256 256 256 192 0 0 0 0 0 160 0 0 0 0 0 0 66 216 181 0 0 192 0 160 64 256 224 0
0 0 0 0 113 165 0 0 0 0 0 0 0 160 0 0 0 0 0 0 96 256 256 0 0 192 0 160 64 256 224 0
0 0 0 0 80 144 0 0 0 0 0 0 0 166 0 0 0 0 0 0 0 192 112 0 0 192 0 160 64 256 224 0
0 0 0 0 80 165 0 0 0 0 0 0 217 256 256 256 256 256 208 0 0 152 128 128 128 176 0 160 64 256 224 0
0 0 0 0 80 214 160 160 160 160 160 160 238 256 256 256 256 256 208 0 0 144 0 0 0 0 0 160 64 256 224 0
0 0 0 0 80 144 0 0 0 0 0 0 156 240 192 192 208 224 156 0 0 144 0 0 0 256 88 166 64 256 224 0
0 240 240 240 245 249 240 240 240 240 240 120 0 192 0 0 64 128 0 0 0 156 192 192 200 256 159 104 64 256 224 0
0 256 256 256 256 256 256 256 256 256 256 128 0 192 0 0 64 128 0 0 0 144 0 0 0 256 196 176 196 256 224 0
0 256 256 256 256 256 256 256 256 256 256 208 160 232 160 160 184 208 160 160 160 212 128 128 128 128 128 128 160 256 224 0
0 256 256 256 256 256 256 256 256 256 256 184 112 112 112 112 112 112 112 112 112 109 64 64 64 64 64 64 112 256 224 0
0 256 256 256 256 256 256 256 256 256 256 128 0 0 0 0 0 0 0 0 0 0 0 0 0 0 0 0 0 64 56 0
0 96 96 96 96 96 96 96 96 96 96 56 0 0 0 0 0 0 0 0 0 0 0 0 0 0 0 0 0 0 0 0