0 0 0 0 0 0 0 0 0 0 0 0 0 0 0 0 0 0 0 0 0 0 0 0 0 0 0 0 0 0 0 0 0 0 0 0 0 0 0 0 0 0 0 0 0 0 0 0 0 0 0 0 0 0 0 0 0 0 0 0 0 0 0 0
0 0 0 0 0 0 0 0 0 0 0 0 0 0 0 0 0 0 0 0 0 0 0 0 0 0 0 0 0 0 0 0 0 0 0 0 0 0 0 0 0 0 0 0 0 0 0 0 0 0 0 0 0 0 0 0 0 0 0 0 0 0 0 0
0 0 0 0 0 0 0 0 0 0 0 0 0 0 0 0 0 0 0 0 0 0 0 0 0 0 0 0 0 0 0 0 0 0 0 0 0 0 0 0 0 0 0 0 0 0 0 0 0 0 0 0 0 0 0 0 0 128 256 256 256 192 0 0
0 0 0 0 0 0 128 256 256 256 256 256 256 256 256 112 0 0 0 0 0 0 0 0 0 0 0 0 0 0 0 0 0 0 0 0 0 0 0 0 0 0 0 0 0 0 0 0 0 0 0 0 0 0 0 0 0 128 256 256 256 192 0 0
0 0 0 0 0 0 128 256 256 256 256 256 256 256 256 112 0 0 0 0 0 0 0 0 0 0 0 0 0 0 0 0 0 0 0 0 0 0 0 0 0 0 0 0 0 0 0 0 0 0 0 0 0 0 0 0 0 128 256 256 256 192 0 0
0 0 0 0 0 0 128 256 256 256 256 256 256 256 256 112 0 0 0 0 0 0 0 0 0 0 0 0 0 0 0 0 0 0 0 0 0 0 0 0 0 0 0 0 0 0 0 0 0 0 0 80 0 0 0 0 0 128 256 256 256 192 0 0
0 0 0 0 0 0 128 256 256 256 256 256 256 256 256 202 160 160 160 160 160 160 160 160 160 160 160 160 160 160 160 160 160 160 160 160 160 160 160 160 160 160 160 160 160 160 160 160 160 160 214 256 135 80 80 80 80 167 256 256 256 192 0 0
0 0 0 0 0 0 128 256 256 256 256 256 256 256 256 193 144 144 144 144 144 144 144 144 144 144 172 186 144 144 144 144 144 144 144 144 144 144 144 144 144 144 144 214 151 144 144 144 144 144 207 256 102 0 0 158 0 144 256 256 256 192 0 0
0 0 0 0 0 0 128 256 256 256 256 256 256 256 256 112 0 0 0 0 0 0 0 0 0 0 64 96 0 0 0 0 0 0 0 0 0 0 0 0 0 60 80 190 91 75 0 0 0 0 144 256 80 0 0 144 0 128 256 256 256 192 0 0
0 0 0 0 0 0 128 256 256 256 256 256 256 256 256 112 0 0 0 0 0 0 0 0 0 0 64 96 0 0 0 0 0 0 0 0 0 0 0 0 0 192 256 256 256 240 0 0 0 0 144 256 80 0 0 144 0 128 256 256 256 192 0 0
0 0 0 0 0 0 0 96 96 206 256 116 96 96 96 0 0 0 0 0 0 0 0 0 0 0 64 96 0 0 0 0 0 0 0 0 0 0 0 0 0 192 256 256 256 240 0 0 0 0 144 256 80 0 0 144 0 128 256 256 256 192 0 0
0 0 0 0 0 0 0 0 0 176 256 0 0 0 0 0 0 0 0 0 0 0 0 0 0 0 64 96 0 0 0 0 0 0 0 0 0 0 0 0 0 192 256 256 256 240 0 0 0 0 144 256 80 0 0 144 0 128 256 256 256 192 0 0
0 0 0 0 0 0 0 0 0 176 256 0 0 0 0 0 0 0 0 0 0 0 0 0 0 0 64 96 0 0 0 0 0 0 0 0 0 0 0 0 0 180 240 248 240 225 0 0 0 0 144 256 80 0 0 144 0 128 256 256 256 192 0 0
0 0 0 0 0 0 0 0 0 176 256 0 0 0 0 0 0 0 0 0 0 0 0 0 0 0 88 116 0 0 0 0 0 0 0 0 0 0 0 0 0 0 0 160 0 0 0 0 0 0 144 256 80 0 0 144 0 128 256 256 256 192 0 0
0 0 0 0 0 0 0 0 0 176 256 0 0 0 0 0 0 0 0 0 0 0 0 0 160 256 256 256 256 256 256 256 256 256 256 256 256 144 0 0 0 0 0 171 64 64 64 64 64 64 171 256 80 0 0 144 0 128 256 256 256 192 0 0
0 0 0 0 0 0 0 0 0 176 256 0 0 0 0 0 0 0 0 0 0 0 0 0 160 256 256 256 256 256 256 256 256 256 256 256 256 144 0 0 0 0 0 171 64 64 64 64 64 64 108 144 0 0 0 144 0 128 256 256 256 192 0 0
0 0 0 0 0 0 0 0 0 176 256 144 128 128 128 128 128 128 128 128 128 128 128 128 208 256 256 256 256 256 256 256 256 256 256 256 256 144 0 0 0 0 0 160 0 0 0 0 0 0 0 0 0 0 0 144 0 128 256 256 256 192 0 0
0 0 0 0 0 0 0 0 0 176 256 0 0 0 0 0 0 0 0 0 0 0 0 0 160 256 256 256 256 256 256 256 256 256 256 256 256 144 0 0 0 0 0 160 0 0 0 0 0 0 80 80 0 0 0 144 0 128 256 256 256 192 0 0
0 0 0 0 0 0 0 0 0 176 256 0 0 0 0 0 0 0 0 0 0 0 0 0 160 256 256 256 256 256 256 256 256 256 256 256 256 144 0 0 0 0 0 160 0 0 0 0 0 80 256 256 112 0 0 144 0 128 256 256 256 192 0 0
0 0 0 0 0 0 0 0 0 176 256 0 0 0 0 0 0 0 0 0 0 0 0 0 80 128 136 200 128 128 128 128 128 144 248 128 128 72 0 0 0 0 0 160 0 0 0 0 0 80 256 256 112 0 0 144 0 128 256 256 256 192 0 0
0 56 224 224 224 224 224 224 224 246 256 228 224 224 224 224 224 224 224 224 224 224 210 0 0 0 0 144 0 0 0 0 0 0 240 0 0 0 0 0 0 0 0 184 128 128 128 128 128 168 256 256 184 128 128 152 0 128 256 256 256 192 0 0
0 64 256 256 256 256 256 256 256 256 256 256 256 256 256 256 256 256 256 256 256 256 240 0 0 0 0 144 0 0 0 0 0 0 240 0 0 0 0 0 0 0 0 162 0 0 0 0 0 90 256 256 120 0 0 0 0 128 256 256 256 192 0 0
0 64 256 256 256 256 256 256 256 256 256 256 256 256 256 256 256 256 256 256 256 256 240 0 0 0 0 144 0 0 0 0 0 0 240 0 0 0 0 0 0 0 0 160 0 0 0 0 0 80 256 256 148 64 64 64 64 160 256 256 256 192 0 0
0 64 256 256 256 256 256 256 256 256 256 256 256 256 256 256 256 256 256 256 256 256 240 0 0 0 0 144 0 0 0 0 0 0 240 0 0 0 0 0 0 0 0 160 0 0 0 0 0 80 256 256 184 128 128 128 128 192 256 256 256 192 0 0
0 64 256 256 256 256 256 256 256 256 256 256 256 256 256 256 256 256 256 256 256 256 244 64 64 64 76 172 64 64 64 64 64 88 244 64 64 64 64 64 64 64 64 172 0 0 0 0 0 0 0 0 0 0 0 0 0 128 256 256 256 192 0 0
0 64 256 256 256 256 256 256 256 256 256 256 256 256 256 256 256 256 256 256 256 256 256 256 256 256 256 256 256 256 256 256 256 256 256 256 256 256 256 256 256 256 256 232 128 128 128 128 128 128 128 128 128 128 128 128 128 192 256 256 256 192 0 0
0 64 256 256 256 256 256 256 256 256 256 256 256 256 256 256 256 256 256 256 256 256 254 224 224 224 224 224 224 224 224 224 224 224 224 224 224 224 224 224 224 224 224 188 0 0 0 0 0 0 0 0 0 0 0 0 0 144 256 256 256 192 0 0
0 64 256 256 256 256 256 256 256 256 256 256 256 256 256 256 256 256 256 256 256 256 240 0 0 0 0 0 0 0 0 0 0 0 0 0 0 0 0 0 0 0 0 0 0 0 0 0 0 0 0 0 0 0 0 0 0 128 256 256 256 192 0 0
0 64 256 256 256 256 256 256 256 256 256 256 256 256 256 256 256 256 256 256 256 256 240 0 0 0 0 0 0 0 0 0 0 0 0 0 0 0 0 0 0 0 0 0 0 0 0 0 0 0 0 0 0 0 0 0 0 64 128 128 128 96 0 0
0 64 256 256 256 256 256 256 256 256 256 256 256 256 256 256 256 256 256 256 256 256 240 0 0 0 0 0 0 0 0 0 0 0 0 0 0 0 0 0 0 0 0 0 0 0 0 0 0 0 0 0 0 0 0 0 0 0 0 0 0 0 0 0
0 0 176 176 176 176 176 176 176 176 176 176 176 176 176 176 176 176 176 176 176 176 165 0 0 0 0 0 0 0 0 0 0 0 0 0 0 0 0 0 0 0 0 0 0 0 0 0 0 0 0 0 0 0 0 0 0 0 0 0 0 0 0 0
0 0 0 0 0 0 0 0 0 0 0 0 0 0 0 0 0 0 0 0 0 0 0 0 0 0 0 0 0 0 0 0 0 0 0 0 0 0 0 0 0 0 0 0 0 0 0 0 0 0 0 0 0 0 0 0 0 0 0 0 0 0 0 0