0 0 0 0 0 0 0 0 0 0 0 0 0 0 0 0 0 0 0 0 0 0 0 0 0 0 0 0 0 0 0 0 0 0 0 0 0 0 0 0 0 0 0 0 0 0 0 0 0 0 0 0 0 0 0 0 0 0 0 0 0 0 0 0
0 0 0 0 0 0 0 0 0 0 0 0 0 0 0 0 0 0 0 0 0 0 0 0 0 0 0 0 0 0 0 0 0 0 0 0 0 0 0 0 0 0 0 0 0 0 0 0 0 0 0 0 0 0 0 0 0 0 0 0 0 0 0 0
0 0 0 0 0 0 0 0 0 0 0 0 0 0 0 0 0 0 0 0 0 0 0 0 0 0 0 0 0 0 0 0 0 0 0 0 0 0 0 0 0 0 0 0 0 0 0 0 0 0 0 0 0 0 0 0 0 0 0 0 0 0 0 0
0 0 0 0 0 0 0 0 0 0 112 256 256 256 256 256 256 256 256 256 256 256 256 256 256 256 256 256 256 256 256 256 256 256 256 256 256 256 256 256 256 256 256 256 256 256 256 256 256 256 256 256 121 0 0 0 0 0 0 0 0 0 0 0
0 0 0 0 0 0 0 0 0 0 112 232 64 64 64 64 64 64 64 64 64 64 64 64 64 64 64 64 64 64 64 64 64 64 64 64 64 64 64 64 64 64 64 64 64 64 64 64 64 64 64 220 128 0 0 0 0 0 0 0 0 0 0 0
0 0 0 0 0 0 0 0 0 0 112 224 0 0 0 0 0 0 0 0 0 0 0 0 0 0 0 0 0 0 0 0 0 0 0 0 0 0 0 0 0 0 0 0 0 0 0 0 0 0 0 208 128 0 0 0 0 0 0 0 0 0 0 0
0 0 0 0 256 256 256 256 256 256 256 256 256 256 256 256 256 256 192 0 0 0 0 0 256 256 256 256 256 256 256 256 256 256 256 256 256 96 0 0 0 0 0 96 128 128 128 128 128 128 128 232 192 128 128 128 128 128 56 0 0 0 0 0
0 0 0 0 256 256 256 256 256 256 256 256 256 256 256 256 256 256 192 0 0 0 0 0 256 256 256 256 256 256 256 256 256 256 256 256 256 96 0 0 0 0 0 192 256 256 256 256 256 256 256 256 256 256 256 256 256 256 112 0 0 0 0 0
0 0 0 0 256 256 256 256 256 256 256 256 256 256 256 256 256 256 192 0 0 0 0 0 256 256 256 256 256 256 256 256 256 256 256 256 256 96 0 0 0 0 0 192 256 256 256 256 256 256 256 256 256 256 256 256 256 256 112 0 0 0 0 0
0 0 0 0 256 256 256 256 256 256 256 256 256 256 256 256 256 256 192 0 0 0 0 0 256 256 256 256 256 256 256 256 256 256 256 256 256 96 0 0 0 0 0 192 256 256 256 256 256 256 256 256 256 256 256 256 256 256 112 0 0 0 0 0
0 0 0 0 256 256 256 256 256 256 256 256 256 256 256 256 256 256 192 0 0 0 0 0 256 256 256 256 256 256 256 256 256 256 256 256 256 96 0 0 0 0 0 192 256 256 256 256 256 256 256 256 256 256 256 256 256 256 112 0 0 0 0 0
0 0 0 0 256 256 256 256 256 256 256 256 256 256 256 256 256 256 192 0 0 0 0 0 256 256 256 256 256 256 256 256 256 256 256 256 256 96 0 0 0 0 0 192 256 256 256 256 256 256 256 256 256 256 256 256 256 256 112 0 0 0 0 0
0 0 0 0 256 256 256 256 256 256 256 256 256 256 256 256 256 256 192 0 0 0 0 0 256 256 256 256 256 256 256 256 256 256 256 256 256 96 0 0 0 0 0 192 256 256 256 256 256 256 256 256 256 256 256 256 256 256 112 0 0 0 0 0
0 0 0 0 256 256 256 256 256 256 256 256 256 256 256 256 256 256 192 0 0 0 0 0 256 256 256 256 256 256 256 256 256 256 256 256 256 96 0 0 0 0 0 192 256 256 256 256 256 256 256 256 256 256 256 256 256 256 112 0 0 0 0 0
0 0 0 0 256 256 256 256 256 256 256 256 256 256 256 256 256 256 192 0 0 0 0 0 256 256 256 256 256 256 256 256 256 256 256 256 256 96 0 0 0 0 0 192 256 256 256 256 256 256 256 256 256 256 256 256 256 256 112 0 0 0 0 0
0 0 0 0 256 256 256 256 256 256 256 256 256 256 256 256 256 256 192 0 0 0 0 0 256 256 256 256 256 256 256 256 256 256 256 256 256 96 0 0 0 0 0 192 256 256 256 256 256 256 256 256 256 256 256 256 256 256 112 0 0 0 0 0
0 0 0 0 256 256 256 256 256 256 256 256 256 256 256 256 256 256 192 0 0 0 0 0 256 256 256 256 256 256 256 256 256 256 256 256 256 96 0 0 0 0 0 192 256 256 256 256 256 256 256 256 256 256 256 256 256 256 112 0 0 0 0 0
0 0 0 0 256 256 256 256 256 256 256 256 256 256 256 256 256 256 192 0 0 0 0 0 256 256 256 256 256 256 256 256 256 256 256 256 256 96 0 0 0 0 0 192 256 256 256 256 256 256 256 256 256 256 256 256 256 256 112 0 0 0 0 0
0 0 0 0 256 256 256 256 256 256 256 256 256 256 256 256 256 256 192 0 0 0 0 0 256 256 256 256 256 256 256 256 256 256 256 256 256 96 0 0 0 0 0 192 256 256 256 256 256 256 256 256 256 256 256 256 256 256 112 0 0 0 0 0
0 0 0 0 256 256 256 256 256 256 256 256 256 256 256 256 256 256 192 0 0 0 0 0 256 256 256 256 256 256 256 256 256 256 256 256 256 96 0 0 0 0 0 192 256 256 256 256 256 256 256 256 256 256 256 256 256 256 112 0 0 0 0 0
0 0 0 0 256 256 256 256 256 256 256 256 256 256 256 256 256 256 192 0 0 0 0 0 256 256 256 256 256 256 256 256 256 256 256 256 256 96 0 0 0 0 0 192 256 256 256 256 256 256 256 256 256 256 256 256 256 256 112 0 0 0 0 0
0 0 0 0 256 256 256 256 256 256 256 256 256 256 256 256 256 256 192 0 0 0 0 0 256 256 256 256 256 256 256 256 256 256 256 256 256 96 0 0 0 0 0 192 256 256 256 256 256 256 256 256 256 256 256 256 256 256 112 0 0 0 0 0
0 0 0 0 256 256 256 256 256 256 256 256 256 256 256 256 256 256 192 0 0 0 0 0 256 256 256 256 256 256 256 256 256 256 256 256 256 96 0 0 0 0 0 192 256 256 256 256 256 256 256 256 256 256 256 256 256 256 112 0 0 0 0 0
0 0 0 0 256 256 256 256 256 256 256 256 256 256 256 256 256 256 192 0 0 0 0 0 256 256 256 256 256 256 256 256 256 256 256 256 256 96 0 0 0 0 0 192 256 256 256 256 256 256 256 256 256 256 256 256 256 256 112 0 0 0 0 0
0 0 0 0 256 256 256 256 256 256 256 256 256 256 256 256 256 256 192 0 0 0 0 0 256 256 256 256 256 256 256 256 256 256 256 256 256 96 0 0 0 0 0 192 256 256 256 256 256 256 256 256 256 256 256 256 256 256 112 0 0 0 0 0
0 88 128 136 256 256 256 256 256 256 256 256 256 256 256 256 256 256 192 0 0 0 0 0 256 256 256 256 256 256 256 256 256 256 256 256 256 96 0 0 0 0 0 192 256 256 256 256 256 256 256 256 256 256 256 256 256 256 112 0 0 0 0 0
0 176 235 211 192 192 192 192 192 192 192 192 192 192 192 192 192 192 146 0 0 96 96 106 256 256 256 256 256 256 256 256 256 256 256 256 256 156 96 96 60 0 0 192 256 256 256 256 256 256 256 256 256 256 256 256 256 256 211 176 176 0 0 0
0 176 144 0 0 0 0 0 0 0 0 0 0 0 0 0 0 0 0 0 64 250 208 211 256 256 256 256 256 256 256 256 256 256 256 256 256 236 224 240 160 0 0 84 112 112 112 112 112 112 112 112 112 112 112 112 112 112 112 112 256 0 0 0
0 176 151 0 0 0 0 0 0 0 0 0 0 0 0 0 0 0 0 0 76 224 0 0 224 224 224 224 224 224 224 224 224 224 224 224 224 84 0 128 166 0 0 0 0 0 0 0 0 0 0 0 0 0 0 0 0 0 0 0 256 0 0 0
0 176 256 256 256 256 256 256 256 256 256 256 256 256 256 256 256 256 256 256 256 224 0 0 0 0 0 0 0 0 0 0 0 0 0 0 0 0 0 128 256 256 256 256 256 256 256 256 256 256 256 256 256 256 256 256 256 256 256 256 256 0 0 0
0 0 64 64 64 64 64 64 64 64 64 64 64 64 64 64 64 64 64 64 64 53 0 0 0 0 0 0 0 0 0 0 0 0 0 0 0 0 0 0 64 64 64 64 64 64 64 64 64 64 64 64 64 64 64 64 64 64 64 64 64 0 0 0
0 0 0 0 0 0 0 0 0 0 0 0 0 0 0 0 0 0 0 0 0 0 0 0 0 0 0 0 0 0 0 0 0 0 0 0 0 0 0 0 0 0 0 0 0 0 0 0 0 0 0 0 0 0 0 0 0 0 0 0 0 0 0 0