0 0 0 0 0 0 0 0 0 0 0 0 0 0 0 0 0 0 0 0 0 0 0 0 0 0 0 0 0 0 0 0
0 0 0 0 0 110 160 160 160 160 160 160 160 160 160 160 160 160 160 160 160 160 160 160 160 160 0 0 0 0 0 0
0 0 0 0 0 162 0 0 0 0 0 0 0 0 0 0 0 0 0 0 0 0 0 0 0 116 64 0 0 0 0 0
0 0 256 256 256 256 256 256 256 96 0 0 256 256 256 256 256 256 176 0 0 72 192 192 192 216 208 192 192 0 0 0
0 0 256 256 256 256 256 256 256 96 0 0 256 256 256 256 256 256 176 0 0 96 256 256 256 256 256 256 256 64 0 0
0 0 256 256 256 256 256 256 256 96 0 0 256 256 256 256 256 256 176 0 0 96 256 256 256 256 256 256 256 64 0 0
0 0 256 256 256 256 256 256 256 96 0 0 256 256 256 256 256 256 176 0 0 96 256 256 256 256 256 256 256 64 0 0
0 0 256 256 256 256 256 256 256 96 0 0 256 256 256 256 256 256 176 0 0 96 256 256 256 256 256 256 256 64 0 0
0 0 256 256 256 256 256 256 256 96 0 0 256 256 256 256 256 256 176 0 0 96 256 256 256 256 256 256 256 64 0 0
0 0 256 256 256 256 256 256 256 96 0 0 256 256 256 256 256 256 176 0 0 96 256 256 256 256 256 256 256 64 0 0
0 0 256 256 256 256 256 256 256 96 0 0 256 256 256 256 256 256 176 0 0 96 256 256 256 256 256 256 256 64 0 0
0 0 256 256 256 256 256 256 256 96 0 0 256 256 256 256 256 256 176 0 0 96 256 256 256 256 256 256 256 64 0 0
0 64 256 256 256 256 256 256 256 96 0 0 256 256 256 256 256 256 176 0 0 96 256 256 256 256 256 256 256 64 0 0
96 146 96 96 96 96 96 96 96 0 108 144 256 256 256 256 256 256 226 164 55 66 176 176 176 176 176 176 176 152 140 0
96 179 144 144 144 144 144 150 144 144 198 0 112 112 112 112 112 112 77 64 179 144 144 144 144 144 144 144 144 144 160 0
0 0 0 0 0 0 0 0 0 0 0 0 0 0 0 0 0 0 0 0 0 0 0 0 0 0 0 0 0 0 0 0