0 0 0 0 0 0 0 0 0 0 0 0 0 0 0 0 0 0 0 0 0 0 0 0 0 0 0 0 0 0 0 0 0 0 0 0 0 0 0 0 0 0 0 0 0 0 0 0 0 0 0 0 0 0 0 0 0 0 0 0 0 0 0 0
0 0 0 0 0 0 0 0 0 0 0 0 0 0 0 0 0 0 0 0 0 0 0 0 0 0 0 0 0 0 0 0 0 0 0 0 0 0 0 0 0 0 0 0 0 0 0 0 0 0 0 0 0 0 0 0 0 0 0 0 0 0 0 0
0 0 0 0 0 0 0 0 0 0 99 144 144 144 144 144 144 144 144 144 144 144 144 144 144 144 144 144 144 144 144 144 144 144 144 144 144 144 144 144 144 144 144 144 144 144 144 144 144 144 144 144 72 0 0 0 0 0 0 0 0 0 0 0
0 0 0 0 0 0 0 0 0 0 176 256 256 256 256 256 256 256 256 256 256 256 256 256 256 256 256 256 256 256 256 256 256 256 256 256 256 256 256 256 256 256 256 256 256 256 256 256 256 256 256 256 128 0 0 0 0 0 0 0 0 0 0 0
0 0 0 0 0 0 0 0 0 0 176 256 160 64 64 64 64 64 64 64 64 64 64 64 64 64 64 64 64 64 64 64 64 64 64 64 64 64 64 64 64 64 64 64 64 64 64 64 64 64 220 256 128 0 0 0 0 0 0 0 0 0 0 0
0 0 0 0 0 0 0 0 0 0 176 256 128 0 0 0 0 0 0 0 0 0 0 0 0 0 0 0 0 0 0 0 0 0 0 0 0 0 0 0 0 0 0 0 0 0 0 0 0 0 208 256 128 0 0 0 0 0 0 0 0 0 0 0
0 0 0 0 0 0 0 0 0 0 176 256 128 0 0 0 0 0 0 0 0 0 0 0 0 0 0 0 0 0 0 0 0 0 0 0 0 0 0 0 0 0 0 0 0 0 0 0 0 0 208 256 128 0 0 0 0 0 0 0 0 0 0 0
0 0 0 0 240 240 240 240 240 240 251 256 248 240 240 240 240 240 180 0 0 0 0 0 240 240 240 240 240 240 240 240 240 240 240 240 240 90 0 0 0 0 0 180 240 240 240 240 240 240 253 256 248 240 240 240 240 240 105 0 0 0 0 0
0 0 0 0 256 256 256 256 256 256 256 256 256 256 256 256 256 256 192 0 0 0 0 0 256 256 256 256 256 256 256 256 256 256 256 256 256 96 0 0 0 0 0 192 256 256 256 256 256 256 256 256 256 256 256 256 256 256 112 0 0 0 0 0
0 0 0 0 256 256 256 256 256 256 256 256 256 256 256 256 256 256 192 0 0 0 0 0 256 256 256 256 256 256 256 256 256 256 256 256 256 96 0 0 0 0 0 192 256 256 256 256 256 256 256 256 256 256 256 256 256 256 112 0 0 0 0 0
0 0 0 0 256 256 256 256 256 256 256 256 256 256 256 256 256 256 192 0 0 0 0 0 256 256 256 256 256 256 256 256 256 256 256 256 256 96 0 0 0 0 0 192 256 256 256 256 256 256 256 256 256 256 256 256 256 256 112 0 0 0 0 0
0 0 0 0 256 256 256 256 256 256 256 256 256 256 256 256 256 256 192 0 0 0 0 0 256 256 256 256 256 256 256 256 256 256 256 256 256 96 0 0 0 0 0 192 256 256 256 256 256 256 256 256 256 256 256 256 256 256 112 0 0 0 0 0
0 0 0 0 256 256 256 256 256 256 256 256 256 256 256 256 256 256 192 0 0 0 0 0 256 256 256 256 256 256 256 256 256 256 256 256 256 96 0 0 0 0 0 192 256 256 256 256 256 256 256 256 256 256 256 256 256 256 112 0 0 0 0 0
0 0 0 0 256 256 256 256 256 256 256 256 256 256 256 256 256 256 192 0 0 0 0 0 256 256 256 256 256 256 256 256 256 256 256 256 256 96 0 0 0 0 0 192 256 256 256 256 256 256 256 256 256 256 256 256 256 256 112 0 0 0 0 0
0 0 0 0 256 256 256 256 256 256 256 256 256 256 256 256 256 256 192 0 0 0 0 0 256 256 256 256 256 256 256 256 256 256 256 256 256 96 0 0 0 0 0 192 256 256 256 256 256 256 256 256 256 256 256 256 256 256 112 0 0 0 0 0
0 0 0 0 256 256 256 256 256 256 256 256 256 256 256 256 256 256 192 0 0 0 0 0 256 256 256 256 256 256 256 256 256 256 256 256 256 96 0 0 0 0 0 192 256 256 256 256 256 256 256 256 256 256 256 256 256 256 112 0 0 0 0 0
0 0 0 0 256 256 256 256 256 256 256 256 256 256 256 256 256 256 192 0 0 0 0 0 256 256 256 256 256 256 256 256 256 256 256 256 256 96 0 0 0 0 0 192 256 256 256 256 256 256 256 256 256 256 256 256 256 256 112 0 0 0 0 0
0 0 0 0 256 256 256 256 256 256 256 256 256 256 256 256 256 256 192 0 0 0 0 0 256 256 256 256 256 256 256 256 256 256 256 256 256 96 0 0 0 0 0 192 256 256 256 256 256 256 256 256 256 256 256 256 256 256 112 0 0 0 0 0
0 0 0 0 256 256 256 256 256 256 256 256 256 256 256 256 256 256 192 0 0 0 0 0 256 256 256 256 256 256 256 256 256 256 256 256 256 96 0 0 0 0 0 192 256 256 256 256 256 256 256 256 256 256 256 256 256 256 112 0 0 0 0 0
0 0 0 0 256 256 256 256 256 256 256 256 256 256 256 256 256 256 192 0 0 0 0 0 256 256 256 256 256 256 256 256 256 256 256 256 256 96 0 0 0 0 0 192 256 256 256 256 256 256 256 256 256 256 256 256 256 256 112 0 0 0 0 0
0 0 0 0 256 256 256 256 256 256 256 256 256 256 256 256 256 256 192 0 0 0 0 0 256 256 256 256 256 256 256 256 256 256 256 256 256 96 0 0 0 0 0 192 256 256 256 256 256 256 256 256 256 256 256 256 256 256 112 0 0 0 0 0
0 0 0 0 256 256 256 256 256 256 256 256 256 256 256 256 256 256 192 0 0 0 0 0 256 256 256 256 256 256 256 256 256 256 256 256 256 96 0 0 0 0 0 192 256 256 256 256 256 256 256 256 256 256 256 256 256 256 112 0 0 0 0 0
0 0 0 0 256 256 256 256 256 256 256 256 256 256 256 256 256 256 192 0 0 0 0 0 256 256 256 256 256 256 256 256 256 256 256 256 256 96 0 0 0 0 0 192 256 256 256 256 256 256 256 256 256 256 256 256 256 256 112 0 0 0 0 0
0 0 0 0 256 256 256 256 256 256 256 256 256 256 256 256 256 256 192 0 0 0 0 0 256 256 256 256 256 256 256 256 256 256 256 256 256 96 0 0 0 0 0 192 256 256 256 256 256 256 256 256 256 256 256 256 256 256 112 0 0 0 0 0
0 0 0 0 256 256 256 256 256 256 256 256 256 256 256 256 256 256 192 0 0 0 0 0 256 256 256 256 256 256 256 256 256 256 256 256 256 96 0 0 0 0 0 192 256 256 256 256 256 256 256 256 256 256 256 256 256 256 112 0 0 0 0 0
0 252 256 256 256 256 256 256 256 256 256 256 256 256 256 256 256 256 192 0 0 0 0 0 256 256 256 256 256 256 256 256 256 256 256 256 256 96 0 0 0 0 0 192 256 256 256 256 256 256 256 256 256 256 256 256 256 256 247 240 240 165 0 0
0 256 235 211 192 192 192 192 192 192 192 192 192 192 192 192 192 192 146 0 0 96 96 106 256 256 256 256 256 256 256 256 256 256 256 256 256 156 96 96 78 0 0 170 224 224 224 224 224 224 224 224 224 224 224 224 224 224 224 224 256 176 0 0
0 256 144 0 0 0 0 0 0 0 0 0 0 0 0 0 0 0 0 0 96 256 256 256 256 256 256 256 256 256 256 256 256 256 256 256 256 256 256 256 208 0 0 0 0 0 0 0 0 0 0 0 0 0 0 0 0 0 0 0 256 176 0 0
0 256 151 0 0 0 0 0 0 0 0 0 0 0 0 0 0 0 0 0 106 256 112 74 224 224 224 224 224 224 224 224 224 224 224 224 224 114 0 217 211 0 0 0 0 0 0 0 0 0 0 0 0 0 0 0 0 0 0 0 256 176 0 0
0 256 256 256 256 256 256 256 256 256 256 256 256 256 256 256 256 256 256 256 256 256 64 0 0 0 0 0 0 0 0 0 0 0 0 0 0 0 0 208 256 256 256 256 256 256 256 256 256 256 256 256 256 256 256 256 256 256 256 256 256 176 0 0
0 192 192 192 192 192 192 192 192 192 192 192 192 192 192 192 192 192 192 192 192 192 0 0 0 0 0 0 0 0 0 0 0 0 0 0 0 0 0 169 208 208 208 208 208 208 208 208 208 208 208 208 208 208 208 208 208 208 208 208 208 150 0 0
0 0 0 0 0 0 0 0 0 0 0 0 0 0 0 0 0 0 0 0 0 0 0 0 0 0 0 0 0 0 0 0 0 0 0 0 0 0 0 0 0 0 0 0 0 0 0 0 0 0 0 0 0 0 0 0 0 0 0 0 0 0 0 0