0 0 0 0 0 0 0 0 0 0 0 0 0 0 0 0 0 0 0 0 0 0 0 0 0 0 0 0 0 0 0 0 0 0 0 0 0 0 0 0 0 0 0 0 0 0 0 0 0 0 0 0 0 0 0 0 0 0 0 0 0 0 0 0
0 0 0 0 0 0 0 0 0 0 0 0 0 0 0 0 0 0 0 0 0 0 0 0 0 0 0 0 0 0 0 0 0 0 0 0 0 0 0 0 0 0 0 0 0 0 0 0 0 0 0 0 0 0 0 0 0 0 0 0 0 0 0 0
0 0 0 0 0 0 0 0 0 0 0 0 0 0 0 0 0 0 0 0 0 0 0 0 0 0 0 0 0 0 0 0 0 0 0 0 0 0 0 0 0 0 0 0 0 0 0 0 0 0 0 0 0 0 0 0 0 0 0 0 0 0 0 0
0 0 0 0 0 0 0 0 0 0 63 144 144 144 144 144 144 144 144 144 144 144 144 144 144 144 144 144 144 144 144 144 144 144 144 144 144 144 144 144 144 144 144 144 144 144 144 144 144 144 144 144 72 0 0 0 0 0 0 0 0 0 0 0
0 0 0 0 0 0 0 0 0 0 112 136 64 64 64 64 64 64 64 64 64 64 64 64 64 64 64 64 64 64 64 64 64 64 64 64 64 64 64 64 64 64 64 64 64 64 64 64 64 64 64 112 128 0 0 0 0 0 0 0 0 0 0 0
0 0 0 0 0 0 0 0 0 0 112 96 0 0 0 0 0 0 0 0 0 0 0 0 0 0 0 0 0 0 0 0 0 0 0 0 0 0 0 0 0 0 0 0 0 0 0 0 0 0 0 64 128 0 0 0 0 0 0 0 0 0 0 0
0 0 0 0 256 256 256 256 256 256 256 256 256 256 256 256 256 256 192 0 0 0 0 0 256 256 256 256 256 256 256 256 256 256 256 256 256 96 0 0 0 0 0 96 128 128 128 128 128 128 128 160 192 128 128 128 128 128 56 0 0 0 0 0
0 0 0 0 256 256 256 256 256 256 256 256 256 256 256 256 256 256 192 0 0 0 0 0 256 256 256 256 256 256 256 256 256 256 256 256 256 96 0 0 0 0 0 192 256 256 256 256 256 256 256 256 256 256 256 256 256 256 112 0 0 0 0 0
0 0 0 0 256 256 256 256 256 256 256 256 256 256 256 256 256 256 192 0 0 0 0 0 256 256 256 256 256 256 256 256 256 256 256 256 256 96 0 0 0 0 0 192 256 256 256 256 256 256 256 256 256 256 256 256 256 256 112 0 0 0 0 0
0 0 0 0 256 256 256 256 256 256 256 256 256 256 256 256 256 256 192 0 0 0 0 0 256 256 256 256 256 256 256 256 256 256 256 256 256 96 0 0 0 0 0 192 256 256 256 256 256 256 256 256 256 256 256 256 256 256 112 0 0 0 0 0
0 0 0 0 256 256 256 256 256 256 256 256 256 256 256 256 256 256 192 0 0 0 0 0 256 256 256 256 256 256 256 256 256 256 256 256 256 96 0 0 0 0 0 192 256 256 256 256 256 256 256 256 256 256 256 256 256 256 112 0 0 0 0 0
0 0 0 0 256 256 256 256 256 256 256 256 256 256 256 256 256 256 192 0 0 0 0 0 256 256 256 256 256 256 256 256 256 256 256 256 256 96 0 0 0 0 0 192 256 256 256 256 256 256 256 256 256 256 256 256 256 256 112 0 0 0 0 0
0 0 0 0 256 256 256 256 256 256 256 256 256 256 256 256 256 256 192 0 0 0 0 0 256 256 256 256 256 256 256 256 256 256 256 256 256 96 0 0 0 0 0 192 256 256 256 256 256 256 256 256 256 256 256 256 256 256 112 0 0 0 0 0
0 0 0 0 256 256 256 256 256 256 256 256 256 256 256 256 256 256 192 0 0 0 0 0 256 256 256 256 256 256 256 256 256 256 256 256 256 96 0 0 0 0 0 192 256 256 256 256 256 256 256 256 256 256 256 256 256 256 112 0 0 0 0 0
0 0 0 0 256 256 256 256 256 256 256 256 256 256 256 256 256 256 192 0 0 0 0 0 256 256 256 256 256 256 256 256 256 256 256 256 256 96 0 0 0 0 0 192 256 256 256 256 256 256 256 256 256 256 256 256 256 256 112 0 0 0 0 0
0 0 0 0 256 256 256 256 256 256 256 256 256 256 256 256 256 256 192 0 0 0 0 0 256 256 256 256 256 256 256 256 256 256 256 256 256 96 0 0 0 0 0 192 256 256 256 256 256 256 256 256 256 256 256 256 256 256 112 0 0 0 0 0
0 0 0 0 256 256 256 256 256 256 256 256 256 256 256 256 256 256 192 0 0 0 0 0 256 256 256 256 256 256 256 256 256 256 256 256 256 96 0 0 0 0 0 192 256 256 256 256 256 256 256 256 256 256 256 256 256 256 112 0 0 0 0 0
0 0 0 0 256 256 256 256 256 256 256 256 256 256 256 256 256 256 192 0 0 0 0 0 256 256 256 256 256 256 256 256 256 256 256 256 256 96 0 0 0 0 0 192 256 256 256 256 256 256 256 256 256 256 256 256 256 256 112 0 0 0 0 0
0 0 0 0 256 256 256 256 256 256 256 256 256 256 256 256 256 256 192 0 0 0 0 0 256 256 256 256 256 256 256 256 256 256 256 256 256 96 0 0 0 0 0 192 256 256 256 256 256 256 256 256 256 256 256 256 256 256 112 0 0 0 0 0
0 0 0 0 256 256 256 256 256 256 256 256 256 256 256 256 256 256 192 0 0 0 0 0 256 256 256 256 256 256 256 256 256 256 256 256 256 96 0 0 0 0 0 192 256 256 256 256 256 256 256 256 256 256 256 256 256 256 112 0 0 0 0 0
0 0 0 0 256 256 256 256 256 256 256 256 256 256 256 256 256 256 192 0 0 0 0 0 256 256 256 256 256 256 256 256 256 256 256 256 256 96 0 0 0 0 0 192 256 256 256 256 256 256 256 256 256 256 256 256 256 256 112 0 0 0 0 0
0 0 0 0 256 256 256 256 256 256 256 256 256 256 256 256 256 256 192 0 0 0 0 0 256 256 256 256 256 256 256 256 256 256 256 256 256 96 0 0 0 0 0 192 256 256 256 256 256 256 256 256 256 256 256 256 256 256 112 0 0 0 0 0
0 0 0 0 256 256 256 256 256 256 256 256 256 256 256 256 256 256 192 0 0 0 0 0 256 256 256 256 256 256 256 256 256 256 256 256 256 96 0 0 0 0 0 192 256 256 256 256 256 256 256 256 256 256 256 256 256 256 112 0 0 0 0 0
0 0 0 0 256 256 256 256 256 256 256 256 256 256 256 256 256 256 192 0 0 0 0 0 256 256 256 256 256 256 256 256 256 256 256 256 256 96 0 0 0 0 0 192 256 256 256 256 256 256 256 256 256 256 256 256 256 256 112 0 0 0 0 0
0 0 0 0 256 256 256 256 256 256 256 256 256 256 256 256 256 256 192 0 0 0 0 0 256 256 256 256 256 256 256 256 256 256 256 256 256 96 0 0 0 0 0 192 256 256 256 256 256 256 256 256 256 256 256 256 256 256 112 0 0 0 0 0
0 88 128 136 256 256 256 256 256 256 256 256 256 256 256 256 256 256 192 0 0 0 0 0 256 256 256 256 256 256 256 256 256 256 256 256 256 96 0 0 0 0 0 192 256 256 256 256 256 256 256 256 256 256 256 256 256 256 112 0 0 0 0 0
0 176 226 211 256 256 256 256 256 256 256 256 256 256 256 256 256 256 192 0 0 96 96 106 256 256 256 256 256 256 256 256 256 256 256 256 256 156 96 96 60 0 0 192 256 256 256 256 256 256 256 256 256 256 256 256 256 256 138 0 0 0 0 0
0 176 96 0 256 256 256 256 256 256 256 256 256 256 256 256 256 256 192 0 64 231 176 181 256 256 256 256 256 256 256 256 256 256 256 256 256 206 176 206 160 0 0 192 256 256 256 256 256 256 256 256 256 256 256 256 256 256 175 112 166 0 0 0
0 176 96 0 224 224 224 224 224 224 224 224 224 224 224 224 224 224 168 0 64 176 0 0 224 224 224 224 224 224 224 224 224 224 224 224 224 84 0 96 160 0 0 84 112 112 112 112 112 112 112 112 112 112 112 112 112 112 0 0 96 0 0 0
0 176 226 208 208 208 208 208 208 208 208 208 208 208 208 208 208 208 208 208 220 176 0 0 0 0 0 0 0 0 0 0 0 0 0 0 0 0 0 96 220 160 160 160 160 160 160 160 160 160 160 160 160 160 160 160 160 160 160 160 196 0 0 0
0 0 64 64 64 64 64 64 64 64 64 64 64 64 64 64 64 64 64 64 64 0 0 0 0 0 0 0 0 0 0 0 0 0 0 0 0 0 0 0 64 64 64 64 64 64 64 64 64 64 64 64 64 64 64 64 64 64 64 64 64 0 0 0
0 0 0 0 0 0 0 0 0 0 0 0 0 0 0 0 0 0 0 0 0 0 0 0 0 0 0 0 0 0 0 0 0 0 0 0 0 0 0 0 0 0 0 0 0 0 0 0 0 0 0 0 0 0 0 0 0 0 0 0 0 0 0 0