0 0 0 0 0 0 0 0 0 0 0 0 0 0 0 0 0 0 0 0 0 0 0 0 0 0 0 0 0 0 0 0 0 0 0 0 0 0 0 0 0 0 0 0 0 0 0 0 0 0 0 0 0 0 0 0 0 0 0 0 0 0 0 0
0 0 0 0 0 0 0 0 0 0 0 0 0 0 0 0 0 0 0 0 0 0 0 18 26 33 40 46 48 54 56 56 56 56 55 48 48 40 35 28 19 0 0 0 0 0 0 0 0 0 0 0 0 0 0 0 0 0 0 0 0 0 0 0
0 0 0 0 0 0 0 0 0 0 0 0 0 0 0 0 0 0 21 36 49 61 64 64 64 64 64 64 64 64 64 64 64 64 64 64 64 64 64 64 64 64 62 52 38 24 0 0 0 0 0 0 0 0 0 0 0 0 0 0 0 0 0 0
0 0 0 0 0 0 0 0 0 0 0 0 0 0 0 32 51 64 64 64 64 64 64 64 64 61 54 48 40 40 40 64 64 36 32 38 40 47 52 60 64 64 64 64 64 64 64 55 36 15 0 0 0 0 0 0 0 0 0 0 0 0 0 0
0 0 0 0 0 0 0 0 0 0 0 0 27 52 64 64 64 64 64 64 58 43 29 18 0 0 0 0 0 0 16 64 64 0 0 0 0 0 0 0 0 14 27 40 54 64 64 64 64 64 57 32 0 0 0 0 0 0 0 0 0 0 0 0
0 0 0 0 0 0 0 0 0 0 36 61 64 64 64 64 64 48 28 0 0 0 0 0 16 25 32 40 44 48 52 64 64 50 48 46 40 34 27 19 0 0 0 0 0 0 24 44 62 64 64 64 63 40 0 0 0 0 0 0 0 0 0 0
0 0 0 0 0 0 0 0 31 61 64 64 64 64 57 30 0 0 0 0 29 44 58 64 64 64 64 64 64 64 64 64 64 64 64 64 64 64 64 64 64 61 49 34 18 0 0 0 0 26 52 64 64 64 63 38 0 0 0 0 0 0 0 0
0 0 0 0 0 0 0 54 64 64 64 64 55 24 0 0 13 36 57 64 64 64 64 64 64 62 48 35 25 16 0 0 0 0 0 0 17 30 64 64 64 64 64 64 64 61 44 21 0 0 0 18 52 64 64 64 59 19 0 0 0 0 0 0
0 0 0 0 0 24 62 64 64 64 63 32 0 0 20 51 64 64 64 64 64 64 64 64 64 24 0 0 0 0 0 0 0 0 0 0 0 41 64 64 28 21 43 63 64 64 64 64 58 32 0 0 0 24 60 64 64 64 33 0 0 0 0 0
0 0 0 0 28 64 64 64 64 55 0 0 15 52 64 64 64 64 64 64 60 32 0 63 64 58 20 31 42 50 56 56 56 56 56 48 40 63 64 50 0 0 0 0 36 62 64 64 64 64 60 27 0 0 0 50 64 64 64 40 0 0 0 0
0 0 0 23 64 64 64 64 54 0 0 34 64 64 64 64 64 64 64 44 0 0 0 45 64 64 64 64 64 64 64 64 64 64 64 64 64 64 64 61 41 15 0 0 0 0 49 64 64 64 64 64 49 0 0 0 43 64 64 64 33 0 0 0
0 0 0 61 64 64 64 56 0 0 43 64 64 64 64 64 64 64 32 0 0 19 55 64 64 64 64 64 64 64 64 64 64 64 64 64 64 64 64 64 64 64 48 0 0 0 0 39 64 64 64 64 64 58 0 0 0 48 64 64 64 16 0 0
0 0 40 64 64 64 64 15 0 40 64 64 64 64 64 64 64 37 0 0 35 64 64 64 64 64 64 64 64 64 64 64 64 64 64 64 64 64 64 64 64 64 64 63 26 0 0 0 45 64 64 64 64 64 56 0 0 0 60 64 64 52 0 0
0 0 63 64 64 64 45 0 19 64 64 64 64 64 64 64 55 0 0 33 64 64 64 64 64 64 64 64 64 64 64 64 64 64 64 64 64 64 64 64 64 64 64 64 64 22 0 0 0 60 64 64 64 64 64 39 0 0 33 64 64 64 17 0
0 21 64 64 64 64 22 0 47 64 64 64 64 64 64 64 29 0 0 63 64 64 64 64 64 64 64 64 64 64 64 64 64 64 64 64 64 64 64 64 64 64 64 64 64 58 0 0 0 37 64 64 64 64 64 62 18 16 25 64 64 64 34 0
0 32 64 64 64 64 64 64 64 64 64 64 64 64 64 64 16 0 24 64 64 64 64 64 64 64 64 64 64 64 64 64 64 64 64 64 64 64 64 64 64 64 64 64 64 64 14 0 0 24 64 64 64 64 64 64 64 64 64 64 64 64 40 0
0 31 64 64 64 64 64 64 64 64 64 64 64 64 64 64 16 0 23 64 64 64 64 64 64 64 64 64 64 64 64 64 64 64 64 64 64 64 64 64 64 64 64 64 64 64 13 0 0 24 64 64 64 64 64 64 64 64 64 64 64 64 40 0
0 21 64 64 64 64 25 0 52 64 64 64 64 64 64 64 26 0 0 62 64 64 64 64 64 64 64 64 64 64 64 64 64 64 64 64 64 64 64 64 64 64 64 64 64 55 0 0 0 34 64 64 64 64 64 64 0 0 0 64 64 64 33 0
0 0 62 64 64 64 40 0 28 64 64 64 64 64 64 64 52 0 0 26 64 64 64 64 64 64 64 64 64 64 64 64 64 64 64 64 64 64 64 64 64 64 64 64 63 17 0 0 0 58 64 64 64 64 64 47 0 0 28 64 64 64 15 0
0 0 40 64 64 64 62 0 0 51 64 64 64 64 64 64 64 31 0 0 27 63 64 64 64 64 64 64 64 64 64 64 64 64 64 64 64 64 64 64 64 64 64 60 19 0 0 0 39 64 64 64 64 64 61 0 0 0 57 64 64 52 0 0
0 0 0 60 64 64 64 51 0 0 54 64 64 64 64 64 64 63 24 0 0 0 48 64 64 64 64 64 64 64 64 64 64 64 64 64 64 64 64 64 64 64 57 0 0 0 0 31 64 64 64 64 64 63 21 0 0 40 64 64 63 14 0 0
0 0 0 19 63 64 64 64 43 0 0 49 64 64 64 64 64 64 64 36 0 0 0 17 63 64 64 64 64 64 64 64 64 64 64 64 64 64 64 54 57 64 64 21 0 0 42 64 64 64 64 64 59 17 0 0 36 64 64 64 31 0 0 0
0 0 0 0 26 63 64 64 64 47 0 0 31 62 64 64 64 64 64 64 56 24 0 30 64 64 35 23 34 42 48 48 48 48 48 40 32 21 0 0 0 63 64 58 29 59 64 64 64 64 64 43 0 0 0 39 64 64 64 36 0 0 0 0
0 0 0 0 0 20 61 64 64 64 57 19 0 0 36 62 64 64 64 64 64 64 57 59 64 58 0 0 0 0 0 0 0 0 0 0 0 0 0 0 0 38 64 64 64 64 64 64 64 48 16 0 0 13 52 64 64 63 30 0 0 0 0 0
0 0 0 0 0 0 0 50 64 64 64 64 46 0 0 0 29 52 64 64 64 64 64 64 64 59 40 27 17 0 0 0 0 0 0 0 0 18 28 42 58 64 64 64 64 64 59 37 0 0 0 0 40 63 64 64 56 16 0 0 0 0 0 0
0 0 0 0 0 0 0 0 26 59 64 64 64 64 46 19 0 0 0 28 45 60 64 64 64 64 64 64 64 64 64 64 63 64 64 64 64 64 64 64 64 64 63 50 34 15 0 0 0 14 41 63 64 64 62 34 0 0 0 0 0 0 0 0
0 0 0 0 0 0 0 0 0 0 32 58 64 64 64 64 57 36 16 0 0 0 0 21 32 41 48 56 60 64 64 64 64 64 64 62 56 50 43 35 26 13 0 0 0 0 13 32 55 64 64 64 62 36 0 0 0 0 0 0 0 0 0 0
0 0 0 0 0 0 0 0 0 0 0 0 24 48 64 64 64 64 64 61 46 30 17 0 0 0 0 0 0 0 16 64 64 0 0 0 0 0 0 0 0 0 15 28 42 58 64 64 64 64 53 29 0 0 0 0 0 0 0 0 0 0 0 0
0 0 0 0 0 0 0 0 0 0 0 0 0 0 0 28 47 62 64 64 64 64 64 64 59 50 41 35 31 24 34 64 64 24 24 24 30 33 40 48 57 64 64 64 64 64 64 50 32 0 0 0 0 0 0 0 0 0 0 0 0 0 0 0
0 0 0 0 0 0 0 0 0 0 0 0 0 0 0 0 0 0 17 32 45 58 64 64 64 64 64 64 64 64 64 64 64 64 64 64 64 64 64 64 64 64 60 47 35 20 0 0 0 0 0 0 0 0 0 0 0 0 0 0 0 0 0 0
0 0 0 0 0 0 0 0 0 0 0 0 0 0 0 0 0 0 0 0 0 0 0 14 22 30 36 40 47 48 48 48 48 48 48 48 40 37 31 24 15 0 0 0 0 0 0 0 0 0 0 0 0 0 0 0 0 0 0 0 0 0 0 0
0 0 0 0 0 0 0 0 0 0 0 0 0 0 0 0 0 0 0 0 0 0 0 0 0 0 0 0 0 0 0 0 0 0 0 0 0 0 0 0 0 0 0 0 0 0 0 0 0 0 0 0 0 0 0 0 0 0 0 0 0 0 0 0