0 0 0 0 0 0 0 0 0 0 0 0 0 0 0 0 0 0 0 0 0 0 0 0 0 0 0 70 86 96 111 118 112 112 97 88 72 0 0 0 0 0 0 0 0 0 0 0 0 0 0 0 0 0 0 0 0 0 0 0 0 0 0 0
0 0 0 0 0 0 0 0 0 0 0 0 0 0 0 0 0 0 0 0 69 118 161 199 233 256 256 256 256 251 244 256 241 247 256 256 256 256 256 237 204 166 124 75 0 0 0 0 0 0 0 0 0 0 0 0 0 0 0 0 0 0 0 0
0 0 0 0 0 0 0 0 0 0 0 0 0 0 0 0 80 151 215 255 253 214 169 129 96 67 0 0 0 0 64 256 0 0 0 0 0 59 88 121 159 202 247 256 256 222 160 89 0 0 0 0 0 0 0 0 0 0 0 0 0 0 0 0
0 0 0 0 0 0 0 0 0 0 0 0 0 87 179 249 251 191 124 63 0 0 0 0 0 0 0 0 0 0 0 256 0 0 0 0 0 0 0 0 0 0 0 0 108 174 241 256 253 189 99 0 0 0 0 0 0 0 0 0 0 0 0 0
0 0 0 0 0 0 0 0 0 0 0 140 238 251 179 89 0 0 0 0 0 0 58 101 139 171 199 219 229 227 224 224 224 224 226 214 190 162 128 88 0 0 0 0 0 0 0 69 155 241 256 245 154 0 0 0 0 0 0 0 0 0 0 0
0 0 0 0 0 0 0 0 0 152 250 232 125 0 0 0 0 0 82 149 211 251 207 155 110 70 0 0 0 0 0 0 0 0 0 0 0 75 114 162 214 245 192 129 59 0 0 0 0 0 97 210 256 254 168 0 0 0 0 0 0 0 0 0
0 0 0 0 0 0 0 115 243 256 222 0 0 0 0 83 177 249 235 204 253 59 0 0 0 0 0 0 0 0 0 0 0 0 0 0 0 0 0 0 0 0 87 198 256 234 149 0 0 0 0 0 80 213 256 250 135 0 0 0 0 0 0 0
0 0 0 0 0 0 198 255 156 79 253 117 0 120 231 256 187 80 0 0 197 225 0 0 0 0 0 0 57 70 80 80 77 64 0 0 0 0 0 0 0 0 0 218 178 93 202 256 202 80 0 0 0 91 256 249 256 215 0 0 0 0 0 0
0 0 0 0 57 234 241 79 0 0 123 252 236 256 188 0 0 0 0 0 0 229 202 149 195 235 256 256 256 256 256 256 256 256 256 256 249 213 170 120 62 0 121 248 0 0 0 65 204 256 205 59 0 246 150 0 215 256 245 78 0 0 0 0
0 0 0 60 246 228 0 0 0 0 195 256 238 86 0 0 0 0 0 136 219 256 256 256 256 256 256 256 256 256 256 256 256 256 256 256 256 256 256 256 256 245 247 177 0 0 0 0 0 107 247 254 238 193 0 0 0 194 256 253 85 0 0 0
0 0 0 237 238 0 0 0 60 237 256 212 0 0 0 0 72 195 256 256 256 256 256 233 184 143 108 81 59 0 88 256 58 0 58 79 106 141 181 230 256 256 256 256 235 128 0 0 0 0 0 228 256 197 0 0 0 0 204 256 248 53 0 0
0 0 193 255 74 0 0 55 246 256 211 0 0 0 0 186 256 256 256 250 179 103 0 0 0 0 0 0 0 0 0 256 0 0 0 0 0 0 0 0 0 98 174 248 256 256 235 96 0 0 0 0 228 256 208 0 0 0 0 237 256 219 0 0
0 80 256 171 0 0 0 230 256 240 0 0 0 79 243 256 256 232 121 0 0 0 0 0 0 0 0 0 0 0 82 256 111 0 0 0 0 0 0 0 0 0 0 0 114 227 256 256 168 0 0 0 52 251 256 169 0 0 0 107 256 256 112 0
0 188 256 52 0 0 149 256 256 109 0 0 77 253 256 255 143 0 0 0 0 0 0 0 0 121 184 233 256 256 256 256 256 256 256 245 200 143 70 0 0 0 0 0 0 0 133 253 256 183 0 0 0 141 256 256 69 0 0 0 238 256 220 0
0 250 231 0 0 0 246 256 244 0 0 0 239 256 253 92 0 0 0 0 0 0 67 197 256 256 256 256 256 256 256 256 256 256 256 256 256 256 256 228 111 0 0 0 0 0 0 79 250 256 118 0 0 0 255 256 178 0 0 0 167 256 256 0
58 256 185 0 0 70 256 256 187 0 0 132 256 256 134 0 0 0 0 0 0 145 256 256 256 256 256 256 256 256 256 256 256 256 256 256 256 256 256 256 256 205 0 0 0 0 0 0 118 256 238 70 80 94 237 256 245 0 0 0 121 256 256 90
61 256 178 0 0 96 256 256 190 80 80 210 256 256 0 0 0 0 0 0 106 256 256 256 256 256 256 256 256 256 256 256 256 256 256 256 256 256 256 256 256 256 186 0 0 0 0 0 0 253 256 256 256 256 254 256 256 0 0 0 114 256 256 93
0 254 210 0 0 76 256 256 256 256 256 256 256 256 0 0 0 0 0 0 188 256 256 256 256 256 256 256 256 256 256 256 256 256 256 256 256 256 256 256 256 256 256 0 0 0 0 0 0 246 256 68 0 0 210 256 249 0 0 0 146 256 256 61
0 204 254 0 0 0 251 256 238 0 0 148 256 256 76 0 0 0 0 0 138 256 256 256 256 256 256 256 256 256 256 256 256 256 256 256 256 256 256 256 256 256 218 0 0 0 0 0 60 256 245 0 0 0 252 256 189 0 0 0 212 256 234 0
0 103 256 121 0 0 165 256 256 85 0 0 248 256 219 0 0 0 0 0 0 201 256 256 256 256 256 256 256 256 256 256 256 256 256 256 256 256 256 256 256 241 53 0 0 0 0 0 209 256 138 0 0 117 256 256 85 0 0 57 256 256 135 0
0 0 217 239 0 0 0 241 256 223 0 0 100 256 256 214 0 0 0 0 0 0 134 255 256 256 256 256 256 256 256 256 256 256 256 256 256 256 256 255 175 0 0 0 0 0 0 205 256 204 0 0 0 240 256 190 0 0 0 197 256 237 0 0
0 0 56 250 191 0 0 76 253 256 181 0 0 108 252 256 248 133 0 0 0 0 203 251 150 185 245 256 256 256 256 256 256 256 256 256 256 208 134 0 0 0 0 0 0 124 245 256 195 0 0 0 204 256 225 0 0 0 133 256 255 83 0 0
0 0 0 95 255 166 0 0 144 256 256 179 0 0 56 214 256 256 246 158 137 251 203 0 0 0 0 0 78 105 122 128 127 110 88 84 253 99 0 0 0 0 62 152 243 256 249 128 0 0 0 201 256 251 232 0 0 108 256 256 126 0 0 0
0 0 0 0 96 250 184 92 250 167 219 256 211 0 0 0 104 224 256 256 256 255 183 121 72 0 0 0 0 0 0 0 0 0 0 0 154 233 74 118 176 239 256 256 250 160 0 0 0 61 226 256 175 0 217 205 136 256 255 123 0 0 0 0
0 0 0 0 0 62 230 256 180 0 0 138 250 250 140 0 0 0 76 168 244 256 256 256 256 256 250 225 203 190 176 176 176 189 202 223 249 256 256 256 256 256 208 237 254 186 92 0 158 254 229 89 0 0 67 256 256 241 83 0 0 0 0 0
0 0 0 0 0 0 0 166 254 158 0 0 0 152 248 241 139 0 0 0 0 66 127 213 256 256 256 256 256 256 256 256 256 256 256 256 256 245 202 152 94 0 0 0 87 215 256 256 229 112 0 0 0 121 244 256 183 0 0 0 0 0 0 0
0 0 0 0 0 0 0 0 61 200 247 145 0 0 0 115 209 254 192 106 0 0 0 234 174 0 0 70 89 102 112 112 109 96 77 56 0 0 0 0 0 0 0 116 203 251 181 83 0 0 0 115 231 256 214 79 0 0 0 0 0 0 0 0
0 0 0 0 0 0 0 0 0 0 72 188 252 179 83 0 0 0 114 181 241 220 216 250 79 0 0 0 0 0 0 0 0 0 0 0 0 0 66 114 166 228 224 161 91 0 0 0 59 155 243 256 202 87 0 0 0 0 0 0 0 0 0 0
0 0 0 0 0 0 0 0 0 0 0 0 0 135 226 242 170 95 0 0 0 0 90 133 171 203 222 214 201 188 176 176 176 190 203 213 215 194 160 120 76 0 0 0 0 78 150 228 256 234 147 0 0 0 0 0 0 0 0 0 0 0 0 0
0 0 0 0 0 0 0 0 0 0 0 0 0 0 0 53 128 199 252 223 168 118 73 0 0 0 0 0 0 0 0 152 216 0 0 0 0 0 0 0 63 106 155 209 253 254 208 137 63 0 0 0 0 0 0 0 0 0 0 0 0 0 0 0
0 0 0 0 0 0 0 0 0 0 0 0 0 0 0 0 0 0 0 65 117 166 209 247 252 227 201 181 165 155 144 200 238 151 161 177 197 219 248 256 250 214 172 123 72 0 0 0 0 0 0 0 0 0 0 0 0 0 0 0 0 0 0 0
0 0 0 0 0 0 0 0 0 0 0 0 0 0 0 0 0 0 0 0 0 0 0 0 0 71 95 118 134 144 159 160 160 160 145 136 120 99 73 0 0 0 0 0 0 0 0 0 0 0 0 0 0 0 0 0 0 0 0 0 0 0 0 0