0 0 0 0 0 0 0 0 0 0 0 0 0 0 0 0 0 0 0 0 0 0 0 0 0 0 0 0 0 0 0 0 0 0 0 0 0 0 0 0 0 0 0 0 0 0 0 0 0 0 0 0 0 0 0 0 0 0 0 0 0 0 0 0
0 0 0 0 0 0 0 0 0 0 0 0 0 0 0 0 0 0 0 0 0 0 0 64 98 127 152 173 190 204 208 208 208 208 206 192 175 154 131 102 68 0 0 0 0 0 0 0 0 0 0 0 0 0 0 0 0 0 0 0 0 0 0 0
0 0 0 0 0 0 0 0 0 0 0 0 0 0 0 0 0 0 78 137 190 239 256 256 256 256 256 256 256 256 256 256 256 256 256 256 256 256 256 256 256 256 243 197 144 86 0 0 0 0 0 0 0 0 0 0 0 0 0 0 0 0 0 0
0 0 0 0 0 0 0 0 0 0 0 0 0 0 0 123 199 253 256 256 256 256 256 256 256 250 221 197 174 159 179 256 256 151 144 157 172 193 217 248 256 256 256 256 256 256 255 208 133 0 0 0 0 0 0 0 0 0 0 0 0 0 0 0
0 0 0 0 0 0 0 0 0 0 0 0 106 204 256 256 256 256 256 256 235 176 123 75 0 0 0 0 0 0 80 256 256 0 0 0 0 0 0 0 0 69 117 169 228 256 256 256 256 256 216 118 0 0 0 0 0 0 0 0 0 0 0 0
0 0 0 0 0 0 0 0 0 0 136 241 256 256 256 256 255 198 117 0 0 0 0 0 57 92 122 149 168 183 212 256 256 196 187 172 153 130 100 66 0 0 0 0 0 0 108 187 253 256 256 256 247 152 0 0 0 0 0 0 0 0 0 0
0 0 0 0 0 0 0 0 120 242 256 256 256 256 230 128 0 0 0 0 111 170 224 256 256 256 256 256 256 256 256 256 256 256 256 256 256 256 256 256 256 237 184 126 61 0 0 0 0 115 220 256 256 256 249 138 0 0 0 0 0 0 0 0
0 0 0 0 0 0 0 212 256 256 256 256 226 100 0 0 0 141 224 256 256 256 256 256 256 250 199 147 107 72 0 0 0 0 0 53 78 132 256 256 256 256 256 256 256 239 163 72 0 0 0 84 214 256 256 256 226 65 0 0 0 0 0 0
0 0 0 0 0 93 248 256 256 256 251 129 0 0 80 200 256 256 256 256 256 256 256 256 256 85 0 0 0 0 0 0 0 0 0 0 0 167 256 256 112 94 184 254 256 256 256 256 224 112 0 0 0 109 244 256 256 253 120 0 0 0 0 0
0 0 0 0 114 255 256 256 256 223 0 0 59 205 256 256 256 256 256 256 244 128 58 254 256 222 70 119 161 193 216 224 224 224 212 185 153 252 256 202 0 0 0 0 154 252 256 256 256 256 231 96 0 0 0 207 256 256 256 145 0 0 0 0
0 0 0 90 255 256 256 256 211 0 0 137 254 256 256 256 256 256 256 180 0 0 0 183 256 256 256 256 256 256 256 256 256 256 256 256 256 256 256 236 152 0 0 0 0 0 208 256 256 256 256 256 183 0 0 0 190 256 256 256 121 0 0 0
0 0 0 244 256 256 256 224 0 0 177 256 256 256 256 256 256 256 130 0 0 73 214 256 256 256 256 256 256 256 256 256 256 256 256 256 256 256 256 256 256 256 183 0 0 0 0 171 256 256 256 256 256 219 0 0 0 203 256 256 253 56 0 0
0 0 168 256 256 256 255 59 0 162 256 256 256 256 256 256 256 144 0 0 141 256 256 256 256 256 256 256 256 256 256 256 256 256 256 256 256 256 256 256 256 256 256 247 87 0 0 0 188 256 256 256 256 256 214 0 0 0 247 256 256 200 0 0
0 0 253 256 256 256 175 0 77 256 256 256 256 256 256 256 220 0 0 136 256 256 256 256 256 256 256 256 256 256 256 256 256 256 256 256 256 256 256 256 256 256 256 256 253 75 0 0 0 247 256 256 256 256 256 141 0 0 143 256 256 256 55 0
0 93 256 256 256 256 81 0 191 256 256 256 256 256 256 256 111 0 0 254 256 256 256 256 256 256 256 256 256 256 256 256 256 256 256 256 256 256 256 256 256 256 256 256 256 225 0 0 0 159 256 256 256 256 256 245 67 64 107 256 256 256 125 0
0 127 256 256 256 256 256 256 256 256 256 256 256 256 256 256 53 0 106 256 256 256 256 256 256 256 256 256 256 256 256 256 256 256 256 256 256 256 256 256 256 256 256 256 256 256 0 0 0 101 256 256 256 256 256 256 256 256 256 256 256 256 159 0
0 127 256 256 256 256 256 256 256 256 256 256 256 256 256 256 0 0 104 256 256 256 256 256 256 256 256 256 256 256 256 256 256 256 256 256 256 256 256 256 256 256 256 256 256 256 0 0 0 98 256 256 256 256 256 256 256 256 256 256 256 256 159 0
0 93 256 256 256 256 105 0 218 256 256 256 256 256 256 256 95 0 0 252 256 256 256 256 256 256 256 256 256 256 256 256 256 256 256 256 256 256 256 256 256 256 256 256 256 219 0 0 0 143 256 256 256 256 256 255 0 0 0 256 256 256 125 0
0 0 253 256 256 256 148 0 119 256 256 256 256 256 256 256 200 0 0 123 256 256 256 256 256 256 256 256 256 256 256 256 256 256 256 256 256 256 256 256 256 256 256 256 250 65 0 0 0 236 256 256 256 256 256 183 0 0 116 256 256 256 55 0
0 0 168 256 256 256 245 0 0 213 256 256 256 256 256 256 256 107 0 0 125 254 256 256 256 256 256 256 256 256 256 256 256 256 256 256 256 256 256 256 256 256 256 241 74 0 0 0 155 256 256 256 256 256 245 0 0 0 229 256 256 200 0 0
0 0 0 244 256 256 256 190 0 0 228 256 256 256 256 256 256 251 84 0 0 59 200 256 256 256 256 256 256 256 256 256 256 256 256 256 256 256 256 256 256 256 222 0 0 0 0 127 256 256 256 256 256 250 77 0 0 161 256 256 253 56 0 0
0 0 0 90 255 256 256 256 165 0 0 209 256 256 256 256 256 256 254 133 0 0 0 78 255 256 256 256 256 256 256 256 256 256 256 256 256 256 256 220 235 256 256 71 0 0 168 256 256 256 256 256 237 68 0 0 136 256 256 256 121 0 0 0
0 0 0 0 114 255 256 256 256 177 0 0 137 250 256 256 256 256 256 256 216 80 0 127 256 256 139 103 145 177 200 208 208 208 196 169 135 91 0 0 57 254 256 226 111 233 256 256 256 256 256 176 0 0 0 153 256 256 256 145 0 0 0 0
0 0 0 0 0 93 248 256 256 256 223 66 0 0 160 252 256 256 256 256 256 256 218 239 256 229 0 0 0 0 0 0 0 0 0 0 0 0 0 0 0 158 256 256 256 256 256 256 256 192 64 0 0 0 208 256 256 253 120 0 0 0 0 0
0 0 0 0 0 0 0 212 256 256 256 255 171 0 0 0 127 221 256 256 256 256 256 256 256 232 151 99 59 0 0 0 0 0 0 0 0 65 108 162 226 256 256 256 256 256 238 152 0 0 0 0 154 252 256 256 226 65 0 0 0 0 0 0
0 0 0 0 0 0 0 0 120 242 256 256 256 254 172 64 0 0 0 123 191 246 256 256 256 256 256 256 256 256 255 240 238 240 242 256 256 256 256 256 256 256 253 206 141 67 0 0 0 0 158 250 256 256 249 138 0 0 0 0 0 0 0 0
0 0 0 0 0 0 0 0 0 0 136 241 256 256 256 256 222 134 53 0 0 0 0 96 137 172 202 229 248 256 256 256 256 256 256 252 233 210 180 146 107 61 0 0 0 0 0 123 212 256 256 256 247 152 0 0 0 0 0 0 0 0 0 0
0 0 0 0 0 0 0 0 0 0 0 0 106 204 256 256 256 256 256 235 172 112 59 0 0 0 0 0 0 0 91 256 241 0 0 0 0 0 0 0 0 0 53 105 164 228 256 256 256 256 216 118 0 0 0 0 0 0 0 0 0 0 0 0
0 0 0 0 0 0 0 0 0 0 0 0 0 0 0 123 199 253 256 256 256 256 256 255 225 189 157 133 110 95 135 256 245 80 80 93 108 129 153 185 221 253 256 256 256 256 255 208 133 0 0 0 0 0 0 0 0 0 0 0 0 0 0 0
0 0 0 0 0 0 0 0 0 0 0 0 0 0 0 0 0 0 78 137 190 239 256 256 256 256 256 256 256 256 256 256 256 256 256 256 256 256 256 256 256 256 243 197 144 86 0 0 0 0 0 0 0 0 0 0 0 0 0 0 0 0 0 0
0 0 0 0 0 0 0 0 0 0 0 0 0 0 0 0 0 0 0 0 0 0 0 64 98 127 152 173 190 204 208 208 208 208 206 192 175 154 131 102 68 0 0 0 0 0 0 0 0 0 0 0 0 0 0 0 0 0 0 0 0 0 0 0
0 0 0 0 0 0 0 0 0 0 0 0 0 0 0 0 0 0 0 0 0 0 0 0 0 0 0 0 0 0 0 0 0 0 0 0 0 0 0 0 0 0 0 0 0 0 0 0 0 0 0 0 0 0 0 0 0 0 0 0 0 0 0 0