0 0 0 0 0 0 0 0 0 0 0 0 0 0 0 0 0 0 0 0 0 0 0 0 0 0 0 0 0 0 0 0 0 0 0 0 0 0 0 0 0 0 0 0 0 0 0 0 0 0 0 0 0 0 0 0 0 0 0 0 0 0 0 0
0 110 176 176 176 176 176 176 176 176 176 176 176 176 176 176 176 176 176 176 176 176 176 176 176 176 176 0 0 0 0 0 176 176 176 176 176 176 176 176 176 176 176 176 176 176 176 176 176 176 176 176 176 176 176 176 176 176 176 176 176 176 0 0
0 160 256 256 256 256 256 256 256 256 256 256 256 256 256 256 256 256 256 256 256 256 256 256 256 256 256 0 0 0 0 0 256 256 256 256 256 256 256 256 256 256 256 256 256 256 256 256 256 256 256 256 256 256 256 256 256 256 256 256 256 256 0 0
0 160 256 256 256 256 256 256 256 256 256 256 256 256 256 256 256 256 256 256 256 256 256 256 256 256 256 0 0 0 0 0 256 256 256 256 256 256 256 256 256 256 256 256 256 256 256 256 256 256 256 256 256 256 256 256 256 256 256 256 256 256 0 0
0 160 256 256 160 128 128 128 128 128 128 208 256 256 256 256 256 256 256 256 256 256 256 256 256 256 256 0 0 0 0 0 256 256 256 256 256 240 192 192 248 256 256 256 256 256 256 256 256 256 256 256 256 256 256 256 256 256 256 256 256 256 0 0
0 160 256 256 64 0 0 0 0 0 0 160 256 256 256 256 256 256 256 256 256 256 256 256 256 256 256 0 0 0 0 0 256 256 256 256 256 192 0 0 224 256 256 256 256 224 128 128 128 128 128 128 128 128 128 128 256 256 256 256 256 256 0 0
0 160 256 256 64 0 0 0 0 0 0 160 256 256 256 256 256 256 256 256 256 256 256 256 256 256 256 228 224 224 224 228 256 256 256 256 256 192 0 0 224 256 256 256 256 192 0 0 0 0 0 0 0 0 0 0 256 256 256 256 256 256 0 0
0 160 256 256 64 0 0 100 160 160 160 220 256 256 256 200 0 0 0 0 0 0 228 256 256 256 256 256 256 256 256 256 256 256 256 256 256 192 0 0 224 256 256 256 256 192 0 0 0 0 0 0 0 0 0 0 256 256 256 256 256 256 0 0
0 160 256 256 64 0 0 160 256 256 256 256 256 256 256 192 0 0 0 0 0 0 224 256 256 256 256 256 256 256 256 256 256 256 256 256 256 192 0 0 224 256 256 256 256 224 128 128 128 128 128 128 128 0 0 0 256 256 256 256 256 256 0 0
0 160 256 256 64 0 0 160 256 256 256 256 256 256 256 192 0 0 0 0 0 0 224 256 256 256 256 256 256 256 256 256 256 256 256 256 256 192 0 0 224 256 256 256 256 256 256 256 256 256 256 256 256 96 0 0 256 256 256 256 256 256 0 0
0 160 256 256 64 0 0 160 256 256 256 256 256 256 256 192 0 0 0 0 0 0 224 256 256 256 256 192 192 192 192 192 192 192 192 192 192 144 0 0 224 256 256 256 256 256 256 256 256 256 256 256 256 96 0 0 256 256 256 256 256 256 0 0
0 160 256 256 136 96 96 196 256 256 256 256 256 256 256 192 0 0 0 0 0 0 224 256 256 256 256 0 0 0 0 0 0 0 0 0 0 0 0 0 224 256 256 256 256 256 256 256 256 256 256 256 256 96 0 0 256 256 256 256 256 256 0 0
0 160 256 256 256 256 256 256 256 256 256 256 256 256 256 192 0 0 0 0 0 0 224 256 256 256 256 0 0 0 0 0 0 0 0 0 0 0 0 0 224 256 256 256 256 256 256 256 256 256 256 256 256 96 0 0 256 256 256 256 256 256 0 0
0 160 256 256 256 256 256 256 256 256 256 256 256 256 256 224 128 128 128 128 128 128 240 256 256 256 256 256 256 256 256 256 256 256 256 256 256 192 0 0 224 256 256 256 256 256 256 256 256 256 256 256 256 96 0 0 256 256 256 256 256 256 0 0
0 160 256 256 256 256 256 256 256 256 256 256 256 256 256 256 256 256 256 256 256 256 256 256 256 256 256 256 256 256 256 256 256 256 256 256 256 192 0 0 224 256 256 256 256 256 256 256 256 256 256 256 256 96 0 0 256 256 256 256 256 256 0 0
0 160 256 256 256 256 256 256 256 256 256 256 256 256 256 256 256 256 256 256 256 256 256 256 256 256 256 256 256 256 256 256 256 256 256 256 256 192 0 0 224 256 256 256 256 256 256 256 256 256 256 256 256 96 0 0 256 256 256 256 256 256 0 0
0 160 256 256 256 256 256 256 256 256 256 256 256 256 256 256 256 256 256 256 256 256 256 256 256 256 256 256 256 256 256 256 256 256 256 256 256 192 0 0 0 0 0 0 0 64 256 256 256 256 256 256 256 96 0 0 256 256 256 256 256 256 0 0
0 160 256 256 256 256 256 256 256 256 256 256 256 256 256 256 256 256 224 224 224 256 256 256 256 256 256 256 256 256 256 256 256 256 256 256 256 192 0 0 0 0 0 0 0 64 256 256 256 256 256 256 256 96 0 0 256 256 256 256 256 256 0 0
0 160 256 256 256 256 256 256 256 256 256 256 256 256 256 256 256 256 0 0 0 256 256 256 256 256 256 256 256 256 256 256 256 256 256 256 256 192 0 0 0 0 0 0 0 64 256 256 256 256 256 256 256 96 0 0 256 256 256 256 256 256 0 0
0 160 256 256 256 256 256 256 256 256 256 256 256 256 256 256 256 256 0 0 0 256 256 256 256 256 256 256 256 256 256 256 256 256 256 256 256 192 0 0 224 256 256 256 256 256 256 256 256 256 256 256 256 96 0 0 256 256 256 256 256 256 0 0
0 160 256 256 200 192 192 224 256 256 256 256 256 256 256 256 256 256 0 0 0 256 256 256 256 256 256 256 256 256 256 256 256 256 256 256 256 192 0 0 224 256 256 256 256 256 256 256 256 256 256 256 256 96 0 0 256 256 256 256 256 256 0 0
0 160 256 256 0 0 0 128 256 256 256 256 256 256 256 256 256 256 0 0 0 256 256 256 256 256 256 240 128 128 128 128 128 128 128 128 128 96 0 0 224 256 256 256 256 256 256 256 256 256 256 256 256 96 0 0 256 256 256 256 256 256 0 0
0 160 256 256 0 0 0 128 256 256 256 256 256 256 256 256 256 256 0 0 0 256 256 256 256 256 256 224 0 0 0 0 0 0 0 0 0 0 0 0 224 256 256 256 128 128 128 128 240 256 256 256 256 96 0 0 256 256 256 256 256 256 0 0
0 160 256 256 0 0 0 128 256 256 256 256 256 256 256 256 256 256 0 0 0 256 256 256 256 256 256 232 64 64 64 64 64 64 64 64 64 0 0 0 224 256 256 256 0 0 0 0 224 256 256 256 256 96 0 0 256 256 256 256 256 256 0 0
0 160 256 256 0 0 0 0 64 64 64 64 184 256 256 256 256 256 0 0 0 256 256 256 256 256 256 256 256 256 256 256 256 256 256 256 256 192 0 0 224 256 256 256 0 0 0 0 224 256 256 256 256 96 0 0 256 256 256 256 256 256 0 0
0 160 256 256 0 0 0 0 0 0 0 0 160 256 256 256 256 256 0 0 0 256 256 256 256 256 256 256 256 256 256 256 256 256 256 256 256 192 0 0 224 256 256 256 0 0 0 0 224 256 256 256 256 96 0 0 256 256 256 256 256 256 0 0
0 160 256 256 0 0 0 0 0 0 0 0 160 256 256 256 256 256 0 0 0 256 256 256 256 256 256 256 256 256 256 256 256 256 256 256 256 192 0 0 224 256 256 256 64 64 64 64 232 256 256 256 256 96 0 0 256 256 256 256 256 256 0 0
0 160 256 256 160 160 160 160 160 160 160 160 220 256 256 256 256 256 0 0 0 256 256 256 256 256 256 256 256 256 256 256 256 256 256 256 256 232 160 160 244 256 256 256 256 256 256 256 256 256 256 256 256 116 0 0 256 256 256 256 256 256 0 0
0 160 256 256 256 256 256 256 256 256 256 256 256 256 256 256 256 256 0 0 0 256 256 256 256 256 256 256 256 256 256 256 256 256 256 256 256 256 256 256 256 256 256 256 256 256 256 256 256 256 256 256 256 256 256 256 256 256 256 256 256 256 0 0
0 160 256 256 256 256 256 256 256 256 256 256 256 256 256 256 256 256 0 0 0 256 256 256 256 256 256 256 256 256 256 256 256 256 256 256 256 256 256 256 256 256 256 256 256 256 256 256 256 256 256 256 256 256 256 256 256 256 256 256 256 256 0 0
0 70 112 112 112 112 112 112 112 112 112 112 112 112 112 112 112 112 0 0 0 112 112 112 112 112 112 112 112 112 112 112 112 112 112 112 112 112 112 112 112 112 112 112 112 112 112 112 112 112 112 112 112 112 112 112 112 112 112 112 112 112 0 0
0 0 0 0 0 0 0 0 0 0 0 0 0 0 0 0 0 0 0 0 0 0 0 0 0 0 0 0 0 0 0 0 0 0 0 0 0 0 0 0 0 0 0 0 0 0 0 0 0 0 0 0 0 0 0 0 0 0 0 0 0 0 0 0