94 128 128 128 128 128 128 128 128 128 128 128 128 128 128 128 128 128 128 128 128 128 128 128 128 128 128 128 128 128 128 128 128 128 128 128 128 128 128 128 128 128 128 128 128 128 128 128 128 128 128 128 128 128 128 128 128 128 128 128 128 128 128 80
160 256 256 256 256 256 256 256 256 256 256 256 256 256 256 256 256 256 256 256 256 256 256 256 256 256 256 256 256 256 256 256 256 256 256 256 256 256 256 256 256 256 256 256 256 256 256 256 241 84 211 256 256 256 256 256 256 256 256 256 256 256 256 128
160 256 256 256 256 256 256 256 238 163 58 0 256 256 256 256 256 256 256 256 256 256 256 256 256 256 256 256 256 256 256 256 256 256 256 256 119 171 256 156 139 256 256 256 256 152 122 256 252 103 0 223 256 256 256 256 107 80 80 80 82 206 256 128
160 256 256 256 256 256 248 138 0 0 131 227 256 256 256 256 256 256 256 256 256 256 256 256 256 256 256 256 256 256 256 256 256 256 256 256 159 0 191 105 116 256 256 256 256 128 96 256 256 253 93 0 248 256 256 256 167 144 144 144 0 169 256 128
160 256 256 256 256 236 0 0 186 256 256 256 256 256 256 256 256 117 115 198 256 256 256 256 256 256 204 138 229 256 256 256 256 256 256 256 256 146 0 0 141 256 256 150 53 0 0 185 256 256 251 0 129 256 256 256 256 256 256 256 0 208 256 128
160 256 256 256 254 74 69 248 256 256 256 256 256 256 256 256 256 187 93 0 68 235 256 256 256 256 204 62 0 0 159 255 256 256 256 256 256 256 205 0 177 256 177 0 156 176 191 243 256 256 256 190 0 210 256 256 256 256 256 256 0 208 256 128
160 256 256 256 156 0 0 83 226 256 256 256 256 256 256 256 256 256 256 238 73 68 256 256 256 256 256 256 236 158 0 60 215 256 256 256 256 256 256 119 0 250 60 136 256 256 256 256 256 256 256 256 101 77 256 256 256 256 256 243 0 222 256 128
160 256 256 230 0 164 216 84 0 141 249 256 256 256 256 256 256 256 256 256 233 0 228 256 256 256 256 256 256 256 240 105 0 129 253 256 256 256 256 251 0 69 0 229 256 256 256 256 256 256 256 256 230 0 168 256 256 256 256 208 0 256 256 128
160 256 256 150 59 256 256 256 176 0 59 256 256 256 256 256 256 256 256 256 256 53 161 256 256 256 256 256 256 256 256 256 182 0 65 182 256 256 256 256 151 0 105 256 256 256 256 256 256 256 256 256 256 162 0 242 256 256 256 208 0 256 256 128
160 256 256 128 96 256 256 256 256 252 225 256 256 256 256 256 256 256 256 256 256 80 144 256 256 256 256 256 256 256 217 125 0 0 0 90 256 256 256 256 207 0 251 256 256 256 256 256 256 256 256 256 256 255 62 96 256 256 256 208 0 256 256 128
160 256 256 128 96 256 256 256 256 256 256 256 256 256 256 107 241 256 256 256 252 0 160 197 153 256 256 251 173 60 0 73 183 255 205 0 238 256 256 256 250 154 256 256 256 256 256 256 256 256 256 256 256 256 224 0 205 256 256 208 0 256 256 128
160 256 256 132 90 256 256 256 256 256 256 218 256 256 256 0 150 256 256 256 166 0 245 144 80 256 256 91 0 134 233 256 256 256 256 0 162 256 256 256 256 256 256 256 256 256 248 256 256 256 256 256 256 256 256 108 0 250 256 247 171 256 256 128
160 256 256 174 118 256 256 256 256 256 226 0 247 256 256 158 0 82 96 57 0 150 256 144 80 256 256 241 251 256 256 256 256 256 256 124 74 256 256 256 256 256 256 256 256 249 0 117 245 255 140 142 256 256 256 248 0 170 256 256 256 256 256 128
160 256 256 256 256 256 256 256 256 256 208 0 256 256 256 256 203 130 128 150 229 256 256 144 80 256 256 256 256 256 256 256 256 256 256 226 0 228 256 256 256 256 256 256 256 256 205 0 0 60 0 195 256 256 256 256 120 86 256 256 256 256 256 128
160 256 256 256 256 256 256 256 256 256 218 0 256 256 256 256 256 256 256 256 256 256 256 144 80 256 256 256 256 256 256 256 256 256 256 256 0 192 256 256 256 256 256 256 256 256 256 252 91 0 236 256 256 256 256 256 205 0 248 256 256 256 256 128
160 256 256 256 256 256 256 256 256 256 224 0 256 256 256 256 256 256 256 256 256 256 250 98 80 256 256 256 256 256 233 192 191 233 256 256 0 192 256 256 256 248 248 256 256 256 256 256 237 0 148 256 256 256 256 256 255 0 175 256 256 256 256 128
160 256 256 256 256 256 256 256 256 256 224 0 256 256 202 217 256 256 256 256 256 238 0 0 79 256 256 256 149 58 0 0 0 0 104 216 0 191 256 256 256 129 79 256 256 256 256 256 256 168 0 255 256 256 256 256 256 120 88 256 256 256 256 128
160 256 256 256 256 256 240 256 256 256 224 0 256 244 0 165 256 256 256 256 238 57 53 0 80 256 256 256 158 155 223 256 256 200 91 0 0 198 256 256 256 231 0 209 256 256 256 256 256 249 0 200 256 256 256 256 256 183 0 256 256 256 256 128
160 256 256 256 256 256 0 198 256 256 224 0 256 136 0 254 256 256 256 256 92 58 239 193 0 173 256 256 256 256 256 256 256 256 256 173 0 249 256 256 256 256 0 192 256 256 256 256 256 256 83 131 256 256 256 256 256 192 0 256 256 256 256 128
160 256 256 256 256 256 0 192 256 256 226 0 248 0 58 216 256 256 256 256 195 234 256 256 163 0 232 256 256 256 256 256 256 256 256 217 0 256 256 256 256 244 0 210 256 256 256 256 256 256 117 105 256 256 256 256 256 192 0 256 256 256 256 128
160 256 256 256 256 256 0 192 256 256 251 0 118 0 98 0 79 157 209 231 254 256 256 256 256 249 256 256 256 256 256 256 256 256 256 185 0 96 96 96 127 142 0 256 256 256 256 256 256 256 128 96 256 256 256 256 256 192 0 256 256 256 256 128
160 256 256 256 256 256 0 183 256 256 256 87 0 128 256 219 123 56 0 0 0 0 0 0 0 0 52 223 256 256 256 256 256 256 256 153 0 128 128 124 83 0 0 136 215 256 256 256 256 68 0 54 140 162 239 256 256 192 0 256 256 256 256 128
160 256 256 256 256 256 103 91 256 256 256 143 0 250 256 256 256 256 256 241 224 224 219 194 192 192 165 243 256 256 251 247 256 256 256 136 84 256 256 256 256 238 154 70 0 0 151 248 256 192 141 83 80 0 0 82 172 191 0 256 256 256 256 128
160 256 256 185 237 256 218 0 188 256 244 0 140 256 256 256 256 256 256 256 256 256 256 256 256 256 256 256 256 256 126 104 256 256 256 165 0 256 256 256 256 256 256 256 241 150 0 72 256 256 256 256 256 256 213 123 0 0 0 256 256 256 256 128
160 256 256 0 176 256 256 136 0 244 111 52 250 256 256 256 256 256 256 256 256 256 256 256 256 256 256 256 256 254 0 155 256 256 256 235 0 205 256 256 256 256 256 256 256 256 246 200 256 256 256 256 256 256 256 256 241 76 58 256 256 256 256 128
160 256 256 0 176 256 256 253 59 0 0 208 256 256 256 256 256 256 256 256 256 256 256 250 256 256 256 256 256 182 0 245 256 256 256 256 84 128 256 256 256 0 211 256 256 256 256 256 256 256 256 256 256 248 253 256 256 79 128 256 256 256 256 128
160 256 256 0 176 256 256 256 238 94 0 56 110 112 151 176 168 138 174 256 256 256 250 0 59 157 240 256 256 91 111 256 256 256 256 256 149 59 256 256 256 110 67 256 256 256 256 256 256 256 256 256 242 0 132 256 234 0 206 256 256 256 256 128
160 256 256 0 170 256 256 256 256 256 219 153 112 110 61 0 0 75 173 256 256 256 256 216 141 0 0 0 94 0 197 256 256 256 256 256 232 0 213 256 256 231 0 219 256 256 256 256 256 256 256 256 107 57 251 250 96 71 256 256 256 256 256 128
160 256 256 111 63 249 256 256 256 256 256 256 256 256 256 256 256 256 256 256 256 256 256 256 256 256 223 179 107 0 0 83 171 248 256 256 256 98 129 256 256 256 78 84 208 208 208 208 208 208 208 198 0 195 256 186 0 209 256 256 256 256 256 128
160 256 256 234 0 0 108 168 256 256 256 256 256 256 256 256 256 256 256 256 256 256 256 256 256 256 256 256 256 252 200 119 0 0 219 256 256 253 253 256 256 256 222 0 0 0 0 0 0 0 0 0 81 256 256 256 256 256 256 256 256 256 256 128
160 256 256 256 253 175 104 142 256 256 256 256 256 256 256 256 256 256 256 256 256 256 256 256 256 256 256 256 256 256 256 256 254 216 255 256 256 256 256 256 256 256 256 256 256 256 256 256 256 256 256 256 256 256 256 256 256 256 256 256 256 256 256 128
103 144 144 144 144 144 144 144 144 144 144 144 144 144 144 144 144 144 144 144 144 144 144 144 144 144 144 144 144 144 144 144 144 144 144 144 144 144 144 144 144 144 144 144 144 144 144 144 144 144 144 144 144 144 144 144 144 144 144 144 144 144 144 87