0 0 0 0 0 0 0 0 0 0 0 0 0 0 0 0 0 0 64 64 64 64 64 64 64 64 64 64 64 64 64 64 64 64 64 64 64 64 64 64 64 64 64 64 64 64 64 55 0 0 0 0 0 0 0 0 0 0 0 0 0 0 0 0
0 0 0 0 0 0 0 0 0 0 0 0 0 0 0 0 0 160 256 256 256 256 256 256 256 256 256 256 256 256 256 256 256 256 256 256 256 256 256 256 256 256 256 256 256 256 256 208 0 0 0 0 0 0 0 0 0 0 0 0 0 0 0 0
0 0 0 0 0 0 0 0 0 0 0 0 0 0 0 0 0 160 256 130 112 112 112 112 112 112 112 112 112 112 112 112 112 112 112 112 112 112 112 112 112 112 112 112 112 121 256 208 0 0 0 0 0 0 0 0 0 0 0 0 0 0 0 0
0 0 0 0 0 0 0 0 0 0 0 0 0 0 0 0 0 160 256 0 0 0 0 0 0 0 0 0 0 0 0 0 0 86 226 177 0 0 0 0 0 0 0 0 0 0 256 208 0 0 0 0 0 0 0 0 0 0 0 0 0 0 0 0
0 0 60 192 192 192 192 192 192 192 192 192 192 192 192 192 192 232 256 200 192 192 192 192 192 132 0 0 0 0 0 0 0 251 256 256 168 0 0 0 0 0 0 0 210 241 256 253 240 240 240 240 240 240 240 240 240 240 240 240 240 150 0 0
0 0 80 256 256 256 256 256 256 256 256 256 256 256 256 256 256 256 256 256 256 256 256 256 256 176 0 0 0 0 0 0 174 256 256 256 256 0 0 0 0 0 0 0 224 256 256 256 256 256 256 256 256 256 256 256 256 256 256 256 256 160 0 0
0 0 80 256 256 256 256 256 256 256 256 256 256 256 256 256 256 256 256 256 256 256 256 256 256 176 0 0 0 0 0 0 251 256 256 256 256 180 112 112 112 112 112 112 238 256 256 256 256 256 256 256 256 256 256 256 256 256 256 256 256 160 0 0
0 0 80 256 256 256 256 256 256 256 256 256 256 256 256 256 256 256 256 256 256 256 256 256 256 176 0 0 0 0 0 74 256 256 256 256 256 256 256 256 256 256 256 256 256 256 256 256 256 256 256 256 256 256 256 256 256 256 256 256 256 160 0 0
0 0 80 256 256 256 256 256 256 256 256 256 256 256 256 256 256 256 256 256 256 256 256 256 256 176 0 0 0 0 0 122 256 256 256 256 256 253 66 64 64 64 64 64 232 256 256 256 256 256 256 256 256 256 256 256 256 256 256 256 256 160 0 0
0 0 80 256 256 256 256 256 256 256 256 256 256 256 256 256 256 256 256 256 256 256 256 256 256 176 0 0 0 0 0 154 256 256 256 256 256 256 0 0 0 0 0 0 224 256 256 256 256 256 256 256 256 256 256 256 256 256 256 256 256 160 0 0
0 0 80 256 256 256 256 256 256 256 256 256 256 256 256 256 256 256 256 256 256 256 256 256 256 176 0 0 0 0 0 172 256 256 256 256 256 256 0 0 0 0 0 0 224 256 256 256 256 256 256 256 256 256 256 256 256 256 256 256 256 160 0 0
0 0 80 256 256 256 256 256 256 256 256 256 256 256 256 256 256 256 256 256 256 256 256 256 256 176 0 0 0 0 0 176 256 256 256 256 256 256 0 0 0 0 0 0 224 256 256 256 256 256 256 256 256 256 256 256 256 256 256 256 256 160 0 0
0 0 80 256 256 256 256 256 256 256 256 256 256 256 256 256 256 256 256 256 256 256 256 256 256 176 0 0 0 0 0 166 256 256 256 256 256 256 0 0 0 0 0 0 196 224 224 224 224 236 256 242 224 224 224 224 224 232 256 244 224 140 0 0
0 0 80 256 256 256 256 256 256 256 256 256 256 256 256 256 256 256 256 256 256 256 256 256 256 256 256 256 256 256 256 256 256 256 256 256 256 256 0 0 0 0 0 0 0 0 0 0 0 96 256 144 0 0 0 0 0 64 256 160 0 0 0 0
0 0 80 256 256 256 256 256 256 256 256 256 256 256 256 256 256 256 256 256 256 256 256 256 256 226 160 160 160 160 160 194 256 256 256 256 256 234 0 0 0 0 0 0 0 0 0 0 0 96 256 144 0 0 0 0 0 64 256 160 0 0 0 0
0 0 0 128 128 128 128 128 248 240 128 128 128 248 232 128 160 256 192 128 128 128 128 128 128 88 0 0 0 0 0 53 256 256 256 256 256 181 0 0 0 0 0 0 0 0 0 0 0 96 256 144 0 0 0 0 0 64 256 160 0 0 0 0
0 0 0 0 0 0 0 66 246 236 0 0 0 240 208 0 69 256 129 0 0 0 0 0 0 0 0 0 0 0 0 0 232 256 256 256 256 183 112 112 112 112 112 130 256 256 256 256 256 256 256 256 256 256 256 256 80 64 256 160 0 0 0 0
0 0 179 0 0 0 0 176 256 256 128 0 0 240 208 0 127 256 175 0 0 0 0 0 0 0 0 0 0 0 0 0 130 256 256 256 256 256 256 256 256 256 256 256 256 256 256 256 256 256 256 256 256 256 256 256 80 64 256 160 0 0 0 0
0 58 256 122 0 0 0 176 256 256 128 0 0 240 208 0 159 256 222 80 80 80 80 0 0 0 0 0 0 0 0 0 0 221 256 256 123 64 64 64 64 64 64 88 256 256 256 256 256 256 256 256 256 256 256 256 80 70 256 160 0 0 0 0
0 115 256 207 112 112 112 211 256 256 128 0 0 240 208 0 147 256 256 256 256 256 256 144 0 0 0 0 0 0 0 0 0 160 256 113 0 0 0 0 0 0 0 0 256 256 256 256 256 256 256 256 256 256 256 256 245 245 256 160 0 0 0 0
0 152 256 256 256 256 256 256 256 256 128 0 0 240 208 0 0 112 113 112 112 166 256 144 0 0 0 0 0 0 0 0 0 160 256 64 0 0 0 0 89 89 0 0 256 256 256 256 256 256 256 256 256 256 256 256 256 256 256 160 0 0 0 0
0 174 256 248 128 128 128 216 256 256 128 0 0 240 208 0 0 0 0 0 0 96 256 144 0 0 0 0 0 0 0 0 0 160 256 64 0 0 0 0 200 208 64 88 256 256 256 256 256 256 256 256 256 256 256 256 102 102 256 160 0 0 0 0
0 190 256 254 0 0 0 132 192 192 96 0 0 240 208 0 0 58 82 99 112 172 256 200 128 116 107 91 71 0 0 0 0 160 256 64 0 0 0 0 247 256 256 256 256 256 256 256 256 256 256 256 256 256 256 256 80 71 256 160 0 0 0 0
0 192 256 256 0 0 0 0 0 0 0 0 99 248 250 250 256 256 256 256 256 256 256 256 256 256 256 256 256 256 256 232 187 217 256 64 0 0 0 0 256 256 136 144 256 256 256 256 256 256 256 256 256 256 256 256 80 64 256 160 0 0 0 0
0 188 256 252 0 0 0 0 0 0 157 252 256 256 256 256 256 256 256 256 256 256 256 256 256 256 256 256 256 256 256 256 256 256 256 221 176 176 176 181 256 256 0 0 256 256 256 256 256 256 256 256 256 256 256 256 234 232 256 160 0 0 0 0
0 172 256 240 0 0 0 0 0 118 256 256 256 256 256 256 256 256 256 256 256 256 256 256 256 256 256 256 256 256 256 256 256 256 256 256 256 256 256 256 256 254 0 0 256 256 256 256 256 256 256 256 256 256 256 256 256 256 256 202 112 0 0 0
0 148 256 256 256 256 256 256 256 256 256 256 256 256 256 256 256 256 256 256 256 256 256 256 256 256 256 256 256 256 256 256 256 256 255 190 61 0 0 0 224 222 0 0 256 256 256 256 256 256 256 256 256 256 256 256 124 124 256 256 256 96 0 0
0 110 256 219 160 160 160 160 160 160 160 160 160 160 178 221 251 256 256 256 256 256 256 256 256 256 256 256 256 256 238 200 155 100 0 0 0 0 0 0 146 146 0 0 256 256 256 256 256 256 256 256 256 256 256 256 80 80 256 256 256 96 0 0
0 0 256 113 0 0 0 0 0 0 0 0 0 0 0 0 0 0 0 67 80 92 96 96 96 84 75 59 0 0 0 0 0 0 0 0 0 0 0 0 0 0 0 0 256 256 256 256 256 256 256 256 256 256 256 256 80 80 256 256 256 96 0 0
0 0 147 0 0 0 0 0 0 0 0 0 0 0 0 0 0 0 0 0 0 0 0 0 0 0 0 0 0 0 0 0 0 0 0 0 0 0 0 0 0 0 0 0 256 256 256 256 256 256 256 256 256 256 256 256 80 65 208 208 208 78 0 0
0 0 0 0 0 0 0 0 0 0 0 0 0 0 0 0 0 0 0 0 0 0 0 0 0 0 0 0 0 0 0 0 0 0 0 0 0 0 0 0 0 0 0 0 0 0 0 0 0 0 0 0 0 0 0 0 0 0 0 0 0 0 0 0
0 0 0 0 0 0 0 0 0 0 0 0 0 0 0 0 0 0 0 0 0 0 0 0 0 0 0 0 0 0 0 0 0 0 0 0 0 0 0 0 0 0 0 0 0 0 0 0 0 0 0 0 0 0 0 0 0 0 0 0 0 0 0 0