0 0 0 0 0 0 0 0 0 160 160 160 160 160 160 160 160 160 160 160 160 160 160 128 0 0 0 0 0 0 0 0
0 0 0 0 0 0 0 0 80 153 0 0 0 0 0 0 0 122 0 0 0 0 0 208 0 0 0 0 0 0 0 0
0 140 224 224 224 224 224 224 234 242 224 224 196 0 0 0 181 256 123 0 0 0 240 256 256 256 256 256 256 256 208 0
0 160 256 256 256 256 256 256 256 256 256 256 224 0 0 0 254 256 234 160 160 160 250 256 256 256 256 256 256 256 208 0
0 160 256 256 256 256 256 256 256 256 256 256 224 0 0 66 256 256 256 0 0 0 241 256 256 256 256 256 256 256 208 0
0 160 256 256 256 256 256 256 256 256 256 256 224 0 0 80 256 256 256 0 0 0 240 256 256 256 256 256 256 256 208 0
0 160 256 256 256 256 256 256 256 256 256 256 240 128 128 168 256 256 256 0 0 0 105 112 121 220 112 112 130 229 91 0
0 120 192 192 244 192 220 220 228 200 192 192 178 80 80 99 256 256 234 0 0 0 0 0 0 192 0 0 0 208 0 0
0 54 0 55 241 0 112 112 170 71 0 0 0 0 0 0 213 256 231 160 160 166 256 256 256 256 256 256 80 208 0 0
58 213 0 113 256 64 112 112 203 211 176 99 0 0 0 0 72 215 0 0 0 0 256 256 256 256 256 256 124 208 0 0
92 256 176 201 256 64 112 112 110 0 0 144 0 0 0 0 0 144 0 0 150 0 256 256 256 256 256 256 179 208 0 0
111 256 0 0 96 0 142 184 153 176 200 228 192 182 162 130 109 144 0 0 252 200 256 256 256 256 256 256 80 208 0 0
102 254 0 0 0 231 256 256 256 256 256 256 256 256 256 256 256 250 208 208 256 0 256 256 256 256 256 256 223 220 0 0
76 242 160 160 160 176 181 224 253 256 256 256 256 256 256 234 189 118 0 0 182 0 256 256 256 256 256 256 80 256 176 0
0 134 0 0 0 0 0 0 0 0 0 0 0 0 0 0 0 0 0 0 0 0 256 256 256 256 256 256 76 224 154 0
0 0 0 0 0 0 0 0 0 0 0 0 0 0 0 0 0 0 0 0 0 0 0 0 0 0 0 0 0 0 0 0