0 0 0 0 0 0 0 0 0 0 0 0 0 0 0 0 0 0 0 0 0 0 0 0 0 0 0 0 0 0 0 0 0 0 0 0 0 0 0 0 0 0 0 0 0 0 0 0 0 0 0 0 0 0 0 0 0 0 0 0 0 0 0 0 0 0 0 0 0 0 0 0 0 0 0 0 0 0 0 0 0 0 0 0 0 0 0 0 0 0
0 0 0 0 0 0 0 0 0 0 0 0 0 0 0 0 0 0 0 0 0 0 0 0 0 0 0 0 0 0 0 0 0 0 0 0 0 0 0 0 0 0 0 0 0 0 0 0 0 0 0 0 0 0 0 0 0 0 0 0 0 0 0 0 0 0 0 0 0 0 0 0 0 0 0 0 0 0 0 0 0 0 0 0 0 0 0 0 0 0
0 0 0 0 0 0 0 0 0 0 0 0 0 0 0 0 0 0 0 0 0 0 0 0 0 0 0 0 0 0 0 0 0 0 0 0 0 0 0 0 0 0 0 0 0 0 0 0 0 0 0 0 0 0 0 0 0 0 0 0 0 0 0 0 0 0 0 0 0 0 0 0 0 0 0 0 0 0 0 0 0 0 0 0 0 0 0 0 0 0
0 0 0 0 0 0 0 0 0 0 0 0 0 0 0 0 0 0 0 0 0 0 0 0 0 0 0 0 0 0 0 0 0 0 0 0 0 0 0 0 0 0 0 0 0 0 0 0 0 0 0 0 0 0 0 0 0 0 0 0 0 0 0 0 0 0 0 0 0 0 0 0 0 0 0 0 0 0 0 0 0 0 0 0 0 0 0 0 0 0
0 0 0 0 3 115 186 226 251 255 224 177 79 6 0 0 0 0 0 0 0 0 0 0 0 0 0 0 0 0 0 0 0 0 0 0 0 0 0 0 0 0 0 0 0 0 0 0 0 0 0 0 0 0 0 0 0 0 0 0 0 0 0 0 0 0 0 0 0 0 0 0 0 0 0 0 0 0 0 0 0 0 0 0 0 0 0 0 0 0
0 0 0 0 59 256 256 256 256 256 256 256 256 256 193 131 84 31 0 0 0 0 0 0 0 0 0 0 0 0 0 0 0 0 0 0 0 0 0 0 0 0 0 0 0 0 0 0 0 0 0 0 0 0 0 0 0 0 0 0 0 0 0 0 0 0 0 0 0 0 0 0 0 0 0 0 0 0 0 0 0 0 0 0 0 0 0 0 0 0
0 0 0 0 5 126 115 59 33 20 75 143 236 256 256 256 256 256 241 207 171 125 73 21 0 0 0 0 0 0 0 0 0 0 0 0 34 138 217 222 125 3 0 0 0 0 0 0 0 10 50 91 148 167 192 192 192 192 171 49 0 0 0 0 0 0 0 0 0 0 0 0 0 0 0 0 2 56 6 0 0 0 0 0 0 0 0 0 0 0
0 0 0 0 0 0 0 0 0 0 0 0 1 40 121 159 211 253 256 256 256 256 256 256 237 214 181 128 81 38 10 0 0 0 0 21 235 256 256 256 256 135 0 19 73 121 150 197 227 252 256 256 256 256 256 256 256 256 256 255 133 1 0 0 0 0 0 0 0 0 0 0 0 0 0 17 185 256 173 10 0 0 0 0 0 0 0 0 0 0
0 0 0 0 0 0 0 0 0 0 0 0 0 0 0 0 0 13 52 84 128 171 224 256 256 256 256 256 256 256 256 231 188 154 136 187 256 256 256 256 256 253 207 250 256 256 256 256 256 256 235 203 150 109 83 80 80 83 212 256 256 177 19 0 0 0 0 0 0 0 0 0 0 0 0 159 256 256 256 197 8 0 0 0 0 0 0 0 0 0
0 0 0 0 0 0 0 0 0 0 0 0 0 0 0 0 0 0 0 0 0 0 0 14 51 78 117 169 211 251 256 256 256 256 256 256 256 256 256 256 256 256 256 256 223 172 137 96 61 36 0 0 0 0 0 32 155 243 256 256 256 256 213 10 0 0 0 0 0 0 0 0 0 0 105 256 256 256 256 256 139 0 0 0 0 0 0 0 0 0
0 0 0 0 0 0 0 0 0 0 0 0 0 0 0 0 0 0 0 0 0 0 0 0 0 0 0 0 0 0 22 61 105 137 144 228 256 256 256 256 256 256 196 44 0 0 0 0 0 0 0 0 0 0 13 226 256 256 256 256 256 256 256 141 0 0 0 0 0 0 0 0 0 19 246 256 256 256 256 256 256 78 0 0 0 0 0 0 0 0
0 0 0 0 0 0 0 0 0 0 0 0 0 0 0 0 0 0 0 0 0 0 0 0 0 0 0 0 0 0 0 0 0 0 0 190 256 256 256 256 256 256 90 0 0 0 0 0 0 0 0 0 0 1 180 256 256 256 256 256 256 256 256 242 9 0 0 0 0 0 0 0 0 119 256 256 256 256 256 256 256 141 0 0 0 0 0 0 0 0
0 0 0 0 0 0 0 0 0 0 0 0 0 0 0 0 0 0 0 0 0 0 0 0 0 0 0 0 0 0 0 0 0 0 0 117 256 256 256 256 256 256 142 0 0 0 0 0 0 0 0 0 0 89 256 256 256 256 256 256 256 256 256 256 81 0 0 0 0 0 0 0 0 175 256 256 256 256 256 256 256 129 0 0 0 0 0 0 0 0
0 0 0 0 0 0 0 0 0 0 0 0 0 0 0 0 0 0 0 0 0 0 0 0 0 0 0 0 0 0 0 0 0 0 0 11 188 256 256 244 165 256 253 72 0 0 0 0 0 0 0 0 0 210 256 256 256 256 256 256 256 256 256 256 112 0 0 0 0 0 0 0 0 206 256 256 256 256 256 256 256 71 0 0 0 0 0 0 0 0
0 0 0 0 0 0 0 0 0 0 0 0 0 0 0 0 0 0 30 117 176 213 248 256 256 248 203 178 110 22 0 0 0 0 0 0 5 68 73 9 0 165 256 169 0 0 0 0 0 0 0 0 0 253 256 256 256 256 256 256 256 256 256 256 102 0 0 0 0 0 0 0 35 254 256 256 256 256 256 256 169 0 0 0 0 0 0 0 0 0
0 0 0 0 0 0 0 0 0 0 0 0 0 0 0 0 44 162 249 256 256 256 256 256 256 256 256 256 256 254 174 51 0 0 0 0 0 0 0 0 0 146 256 164 0 0 0 0 0 0 0 0 0 256 256 256 256 256 256 256 256 256 256 232 22 0 0 0 0 0 0 0 151 256 227 252 256 256 247 129 5 0 0 0 0 0 0 0 0 0
0 0 0 0 0 0 0 0 0 0 0 0 0 0 4 133 251 256 256 256 256 256 256 256 256 256 256 256 256 256 256 250 115 0 0 0 0 0 0 4 122 256 256 75 0 0 0 0 0 0 0 0 0 227 256 256 256 256 256 256 256 256 250 53 0 0 0 0 0 0 0 2 230 256 77 12 45 48 17 0 0 0 0 0 0 0 0 0 0 0
0 0 0 0 0 0 0 0 0 0 0 0 0 15 202 256 256 256 256 256 256 256 256 256 256 256 256 256 256 256 247 256 256 109 0 0 0 0 37 212 256 256 148 0 0 0 0 0 0 0 0 0 0 187 256 256 256 256 256 256 256 246 94 0 0 0 0 0 0 0 0 75 256 243 7 0 0 0 0 0 0 0 0 0 0 0 0 0 0 0
0 0 0 0 0 0 0 0 0 0 0 0 1 173 256 256 256 256 256 256 256 256 256 256 256 256 240 208 212 124 17 131 256 253 58 27 68 155 247 256 240 111 2 0 0 0 0 0 0 0 0 0 0 142 256 256 256 256 256 256 212 35 0 0 0 0 0 0 0 0 0 176 256 147 0 0 0 0 0 0 0 0 0 0 0 0 0 0 0 0
0 0 0 0 0 0 0 0 0 0 0 0 127 256 256 256 256 256 256 256 256 256 256 256 195 30 2 0 0 0 0 52 238 256 251 256 256 256 256 197 30 0 0 0 0 0 0 0 0 0 0 0 0 65 255 256 256 256 256 155 11 0 0 0 0 0 0 0 0 0 22 250 256 53 0 0 0 0 0 0 0 0 0 0 0 0 0 0 0 0
0 0 0 0 0 0 0 0 0 0 0 41 251 256 256 256 256 256 256 256 256 256 256 230 24 0 0 0 0 86 199 256 256 256 256 255 218 175 68 0 0 0 0 0 0 0 0 0 0 0 0 0 0 0 94 246 256 202 76 0 0 0 0 0 0 0 0 0 0 0 113 256 209 0 0 0 0 0 0 0 0 0 0 0 0 0 0 0 0 0
0 0 0 0 0 0 0 0 0 0 0 168 256 256 256 256 256 256 256 256 256 256 253 68 0 0 0 10 165 256 256 254 177 109 55 17 0 0 0 0 0 0 0 0 0 0 0 0 0 0 0 0 0 0 0 160 256 184 0 0 0 0 0 0 0 0 0 0 0 0 213 256 109 0 0 0 0 0 0 0 0 0 0 0 0 0 0 0 0 0
0 0 0 0 0 0 0 0 0 0 31 254 256 256 256 256 256 256 256 256 256 256 129 0 0 0 11 194 256 254 141 32 0 0 0 0 0 0 0 0 0 0 0 0 0 0 0 0 0 0 0 0 0 0 0 39 255 256 98 0 0 0 0 0 0 0 0 0 0 61 256 249 20 0 0 0 0 0 0 0 0 0 0 0 0 0 0 0 0 0
0 0 0 0 0 0 0 0 0 0 90 256 256 256 256 256 256 256 256 256 256 200 4 0 0 1 183 256 245 65 0 0 0 0 0 0 0 0 0 0 0 0 0 0 0 0 0 0 0 0 0 0 0 0 0 0 143 256 246 127 116 17 0 0 0 0 0 0 0 164 256 167 0 0 0 0 0 0 0 0 0 0 0 0 0 0 0 0 0 0
0 0 0 0 0 0 0 0 0 0 96 256 256 256 256 256 256 256 256 256 255 45 0 0 0 118 256 250 65 0 0 0 0 0 0 0 0 0 0 0 0 0 0 0 0 0 0 0 0 0 0 0 0 0 0 0 3 196 256 256 256 222 40 0 0 0 0 0 91 254 256 88 32 32 32 18 0 0 0 0 0 0 0 0 0 0 0 0 0 0
0 0 0 0 0 0 0 0 0 0 96 256 256 256 256 256 256 256 256 256 194 0 0 0 59 253 256 111 0 0 0 0 0 0 0 0 0 0 0 0 0 0 0 0 0 0 0 0 0 0 0 0 0 0 0 0 35 245 256 256 256 256 244 224 224 224 224 224 244 256 256 256 256 256 256 256 234 161 53 0 0 0 0 0 0 0 0 0 0 0
0 0 0 0 0 0 0 0 0 0 96 256 256 256 256 256 256 256 256 256 57 0 0 6 224 256 172 0 0 0 0 0 0 0 0 0 0 0 0 0 0 0 0 0 0 0 0 0 0 0 0 0 0 0 0 31 205 256 256 256 256 256 256 256 256 256 256 256 256 256 256 253 240 240 244 256 256 256 255 154 5 0 0 0 0 0 0 0 0 0
0 0 0 0 0 0 0 0 0 0 77 256 256 256 256 256 256 256 256 211 0 0 0 84 256 234 14 0 0 0 0 0 0 0 0 0 0 0 0 0 0 0 0 0 0 0 0 0 0 0 0 0 0 0 89 244 256 256 256 256 256 256 126 48 48 48 48 48 48 48 39 5 0 0 0 14 66 173 255 256 150 0 0 0 0 0 0 0 0 0
0 0 0 0 0 0 0 0 0 0 28 256 256 256 256 256 256 256 256 134 0 0 0 128 256 152 0 0 0 0 0 0 0 0 0 0 0 0 0 0 0 21 32 21 0 0 0 0 0 0 0 0 11 159 256 256 203 205 256 256 256 192 1 0 0 0 0 0 0 0 0 0 0 0 0 0 0 0 93 256 254 24 0 0 0 0 0 0 0 0
0 0 0 0 0 0 0 0 0 0 0 208 256 256 256 256 256 256 256 81 0 0 0 128 256 144 0 0 0 0 0 0 0 0 0 0 0 0 30 197 252 256 256 254 177 71 0 0 0 0 0 41 207 256 254 147 3 1 45 95 256 245 4 0 0 0 0 0 0 0 0 0 0 0 0 0 0 0 0 211 256 79 0 0 0 0 0 0 0 0
0 0 0 0 0 0 0 0 0 0 0 103 256 256 256 256 256 256 256 45 0 0 0 119 256 179 0 0 0 0 0 0 0 0 0 0 0 80 235 256 256 256 256 256 256 256 161 32 85 163 203 255 256 237 74 0 0 0 0 5 254 256 31 0 0 0 0 0 0 0 0 0 0 0 0 0 0 0 0 192 256 80 0 0 0 0 0 0 0 0
0 0 0 0 0 0 0 0 0 0 0 10 222 256 256 256 256 256 216 0 0 0 0 54 255 255 80 0 0 0 0 0 0 0 0 0 136 256 256 256 256 256 256 256 256 256 256 256 256 256 256 254 185 38 0 0 0 0 0 0 211 256 103 0 0 0 0 0 0 0 0 0 0 0 0 0 0 0 0 225 256 67 0 0 0 0 0 0 0 0
0 0 0 0 0 0 0 0 0 0 0 0 54 250 256 256 256 250 62 0 0 0 0 0 150 256 240 29 0 0 0 0 0 0 0 52 256 256 256 256 256 256 256 256 256 256 256 256 244 155 85 38 0 0 0 0 0 0 0 0 125 256 191 0 0 0 0 0 0 0 0 0 0 0 0 0 0 0 22 256 256 25 0 0 0 0 0 0 0 0
0 0 0 0 0 0 0 0 0 0 0 0 0 83 246 256 256 176 43 3 0 0 0 0 6 206 256 200 6 0 0 0 0 0 32 205 256 256 256 256 256 256 256 256 256 256 256 256 253 58 0 0 0 0 0 0 0 0 0 0 64 256 208 0 0 0 0 0 0 0 0 0 0 0 0 0 0 0 114 256 209 0 0 0 0 0 0 0 0 0
0 0 0 0 0 0 0 0 0 0 0 0 0 0 48 204 256 256 256 250 204 145 112 96 96 137 256 256 150 0 0 0 0 0 120 256 256 256 256 256 256 256 256 256 256 256 256 256 256 110 0 0 0 0 0 0 0 0 0 0 64 256 208 0 0 0 0 0 0 0 0 0 0 0 0 0 0 1 215 256 108 0 0 0 0 0 0 0 0 0
0 0 0 0 0 0 0 0 0 0 0 0 0 0 0 0 64 191 253 256 256 256 256 256 256 256 256 256 256 152 10 0 27 133 226 256 253 201 216 256 256 256 256 256 256 256 256 256 243 35 0 0 0 0 0 0 0 0 0 0 69 256 208 0 0 0 0 0 0 0 0 0 0 0 0 0 0 78 256 242 13 0 0 0 0 0 0 0 0 0
0 0 0 0 0 0 0 0 0 0 0 0 0 0 0 0 0 0 6 38 93 149 176 176 176 176 176 186 255 256 196 160 251 256 256 233 72 0 3 75 135 159 192 208 208 204 175 128 29 0 0 0 0 0 0 0 0 0 0 0 96 256 184 0 0 0 0 0 0 0 0 0 0 0 0 0 19 223 256 142 0 0 0 0 0 0 0 0 0 0
0 0 0 0 0 0 0 0 0 0 0 0 0 0 0 0 0 0 0 0 0 0 0 0 0 0 0 0 80 243 256 256 256 201 95 10 0 0 0 0 0 0 0 0 0 0 0 0 0 0 0 0 0 0 0 0 0 0 0 0 123 256 175 0 0 0 0 0 0 0 0 0 0 0 0 39 205 256 226 19 0 0 0 0 0 0 0 0 0 0
0 0 0 0 0 0 0 0 0 0 0 0 0 0 0 0 0 0 0 0 0 0 0 0 0 0 0 0 0 54 242 256 222 29 0 0 0 0 0 0 0 0 0 0 0 0 0 0 0 0 0 0 0 0 0 0 0 0 0 0 160 256 124 0 0 0 0 0 0 0 0 0 0 1 120 251 256 243 48 0 0 0 0 0 0 0 0 0 0 0
0 0 0 0 0 0 0 0 0 0 0 0 0 0 0 0 0 0 0 0 0 0 0 0 0 0 0 0 0 0 57 239 256 237 96 1 0 0 0 0 0 0 0 0 0 0 0 0 0 0 0 0 0 0 0 0 0 0 0 0 162 256 112 0 0 0 0 0 0 0 0 0 13 165 256 256 190 40 0 0 0 0 0 0 0 0 0 0 0 0
0 0 0 0 0 0 0 0 0 0 0 0 0 0 0 0 0 0 0 0 0 0 0 0 0 0 0 0 0 0 0 37 206 256 256 207 91 11 0 0 0 0 0 0 0 0 0 0 0 0 0 0 0 0 0 0 0 0 0 0 209 256 88 0 0 0 0 0 0 0 0 71 222 256 253 112 0 0 0 0 0 0 0 0 0 0 0 0 0 0
0 0 0 0 0 0 0 0 0 0 0 0 0 0 0 0 0 0 0 0 0 0 0 0 0 0 0 0 0 0 0 0 8 128 246 256 256 234 127 41 0 0 0 0 0 0 0 0 0 0 0 0 0 0 0 0 0 0 0 0 224 256 64 0 0 0 0 0 0 55 182 256 256 232 69 0 0 0 0 0 0 0 0 0 0 0 0 0 0 0
0 0 0 0 0 0 0 0 0 0 0 0 0 0 0 0 0 0 0 0 0 0 0 0 0 0 0 0 0 0 0 0 0 0 23 137 229 256 256 256 232 185 142 106 56 11 0 0 0 0 0 0 0 0 0 0 0 0 15 178 251 256 256 237 85 0 45 123 217 256 256 254 153 17 0 0 0 0 0 0 0 0 0 0 0 0 0 0 0 0
0 0 0 0 0 0 0 0 0 0 0 0 0 0 0 0 0 0 0 0 0 0 0 0 0 0 0 0 0 0 0 0 0 0 0 0 6 99 193 252 256 256 256 256 256 251 217 182 150 135 128 128 128 133 144 151 160 160 201 256 256 256 256 256 249 238 256 256 256 250 166 44 0 0 0 0 0 0 0 0 0 0 0 0 0 0 0 0 0 0
0 0 0 0 0 0 0 0 0 0 0 0 0 0 0 0 0 0 0 0 0 0 0 0 0 0 0 0 0 0 0 0 0 0 0 0 0 0 0 13 67 107 147 188 236 256 256 256 256 256 256 256 256 256 256 256 256 256 256 256 256 256 256 256 256 256 251 193 104 18 0 0 0 0 0 0 0 0 0 0 0 0 0 0 0 0 0 0 0 0
0 0 0 0 0 0 0 0 0 0 0 0 0 0 0 0 0 0 0 0 0 0 0 0 0 0 0 0 0 0 0 0 0 0 0 0 0 0 0 0 0 0 0 0 1 31 74 110 139 144 144 144 144 144 144 135 128 119 112 112 112 112 112 111 93 58 11 0 0 0 0 0 0 0 0 0 0 0 0 0 0 0 0 0 0 0 0 0 0 0
0 0 0 0 0 0 0 0 0 0 0 0 0 0 0 0 0 0 0 0 0 0 0 0 0 0 0 0 0 0 0 0 0 0 0 0 0 0 0 0 0 0 0 0 0 0 0 0 0 0 0 0 0 0 0 0 0 0 0 0 0 0 0 0 0 0 0 0 0 0 0 0 0 0 0 0 0 0 0 0 0 0 0 0 0 0 0 0 0 0
0 0 0 0 0 0 0 0 0 0 0 0 0 0 0 0 0 0 0 0 0 0 0 0 0 0 0 0 0 0 0 0 0 0 0 0 0 0 0 0 0 0 0 0 0 0 0 0 0 0 0 0 0 0 0 0 0 0 0 0 0 0 0 0 0 0 0 0 0 0 0 0 0 0 0 0 0 0 0 0 0 0 0 0 0 0 0 0 0 0
0 0 0 0 0 0 0 0 0 0 0 0 0 0 0 0 0 0 0 0 0 0 0 0 0 0 0 0 0 0 0 0 0 0 0 0 0 0 0 0 0 0 0 0 0 0 0 0 0 0 0 0 0 0 0 0 0 0 0 0 0 0 0 0 0 0 0 0 0 0 0 0 0 0 0 0 0 0 0 0 0 0 0 0 0 0 0 0 0 0
0 0 0 0 0 0 0 0 0 0 0 0 0 0 0 0 0 0 0 0 0 0 0 0 0 0 0 0 0 0 0 0 0 0 0 0 0 0 0 0 0 0 0 0 0 0 0 0 0 0 0 0 0 0 0 0 0 0 0 0 0 0 0 0 0 0 0 0 0 0 0 0 0 0 0 0 0 0 0 0 0 0 0 0 0 0 0 0 0 0