0 0 0 0 0 0 0 0 0 0 0 0 0 0 0 0 0 0 0 0 0 0 0 0 0 0 0 0 0 0 0 0 0 0 0 0 0 0 0 0 0 0 0 0 0 0 0 0 0 0 0 0 0 0 0 0 0 0 0 0 0 0 0 0
0 0 0 0 0 0 0 0 0 0 0 0 0 0 0 0 0 0 0 0 0 0 0 0 0 0 0 0 0 0 0 0 0 0 0 0 0 0 0 0 0 0 0 0 0 0 0 0 0 0 0 0 0 0 0 0 0 0 0 0 0 0 0 0
0 0 0 0 0 0 0 0 14 37 48 48 48 48 67 80 80 80 80 80 80 80 80 80 80 80 80 80 80 80 80 83 78 26 0 0 0 0 0 0 0 0 0 0 0 0 0 0 0 0 0 0 0 0 0 0 0 0 0 0 0 0 0 0
0 0 0 0 0 4 100 203 254 256 256 256 256 256 256 256 256 256 256 256 256 256 256 256 256 256 256 256 256 256 256 256 256 255 203 129 107 75 48 48 48 48 48 48 48 48 48 48 48 28 0 0 0 0 0 0 0 0 0 0 0 0 0 0
0 0 0 0 26 201 256 256 256 256 256 256 256 256 256 256 256 256 256 256 256 256 256 256 256 256 256 256 256 256 256 256 256 256 256 256 256 256 256 256 256 256 256 256 256 256 256 256 256 256 216 94 1 0 0 0 0 0 0 0 0 0 0 0
0 0 0 0 187 256 256 256 256 256 256 256 256 256 256 256 256 256 256 256 256 256 256 256 256 256 256 256 256 256 256 256 256 256 256 256 256 256 256 256 256 256 256 256 256 256 256 256 256 256 256 256 188 30 0 0 0 0 0 0 0 0 0 0
0 0 0 86 256 256 256 256 256 256 256 256 256 256 256 256 256 256 256 256 256 256 256 256 256 256 256 256 256 256 256 256 256 256 256 256 256 256 256 256 256 256 256 256 256 256 256 256 256 256 256 256 256 241 104 3 0 0 0 0 0 0 0 0
0 0 0 200 256 256 256 256 256 256 256 256 256 256 250 225 224 224 224 224 224 224 224 224 224 224 230 256 256 256 256 256 256 256 256 256 256 256 256 256 256 256 256 256 256 256 256 256 256 256 256 256 256 256 256 193 42 0 0 0 0 0 0 0
0 0 34 255 256 256 256 256 148 17 0 0 0 0 0 0 0 0 0 0 0 0 0 0 0 0 48 256 256 256 256 256 256 256 166 189 209 241 256 256 256 256 256 256 256 256 256 256 256 256 256 256 256 256 256 256 246 94 0 0 0 0 0 0
0 0 88 256 256 256 256 245 15 0 0 0 0 0 0 0 0 0 0 0 0 0 0 0 0 0 48 256 256 256 256 256 256 256 16 0 0 0 0 0 0 0 0 0 0 0 0 0 9 128 251 256 256 256 256 256 256 256 130 0 0 0 0 0
0 0 112 256 256 256 256 221 0 0 0 0 0 0 0 0 0 0 0 0 0 0 0 0 0 0 48 256 256 256 256 256 256 256 18 0 0 0 0 0 0 0 0 0 0 0 0 0 0 0 53 213 256 256 256 256 256 256 256 92 0 0 0 0
0 0 96 256 256 256 256 230 0 0 0 0 0 0 0 0 0 0 0 0 0 0 0 0 0 21 173 256 256 256 256 256 256 256 203 21 0 0 0 0 0 0 0 0 0 0 0 0 0 0 0 7 121 247 256 256 256 256 256 236 10 0 0 0
0 0 139 256 256 256 256 203 0 0 0 0 0 0 0 0 0 0 0 0 0 0 0 0 9 216 256 256 256 256 256 256 256 256 256 191 1 0 0 0 0 0 0 0 0 0 0 0 0 0 0 0 0 39 214 256 256 256 256 256 96 0 0 0
0 0 167 256 256 256 256 200 93 96 96 96 96 96 96 96 96 96 96 96 96 96 96 96 149 256 256 256 256 256 256 256 256 256 256 256 101 0 0 0 0 0 0 0 0 16 16 16 16 16 16 16 16 16 31 226 256 256 256 256 191 0 0 0
0 0 130 256 256 256 256 256 256 256 256 256 256 256 256 256 256 256 256 256 256 256 256 256 256 256 256 256 256 256 256 256 256 256 256 256 250 240 240 240 240 240 240 240 256 256 256 256 256 256 256 256 256 256 256 256 256 256 256 256 254 23 0 0
0 0 125 256 256 256 256 256 256 256 256 256 256 256 256 256 256 256 256 256 256 256 256 256 256 256 256 256 256 256 256 256 256 256 256 256 256 256 256 256 256 256 256 256 256 256 256 256 256 256 256 256 256 256 256 256 256 256 256 256 256 95 0 0
0 0 112 256 256 256 256 256 256 256 256 256 256 256 256 256 256 256 256 256 256 256 256 256 256 256 256 256 256 256 256 256 256 256 256 256 256 256 256 256 256 256 256 256 256 256 256 256 256 256 256 256 256 256 256 256 256 256 256 256 256 172 0 0
0 0 112 256 256 256 256 256 256 256 256 256 256 256 256 256 256 256 256 256 256 256 256 256 256 256 256 256 256 256 256 256 256 256 256 256 256 256 256 256 256 256 256 256 256 256 256 256 256 256 256 256 256 256 256 256 256 256 256 256 256 221 0 0
0 0 112 256 256 256 256 238 205 208 208 208 208 208 208 208 208 208 208 208 208 208 208 208 248 256 256 256 256 256 256 256 256 256 256 256 256 256 256 256 256 256 256 256 256 256 256 256 256 256 256 256 256 256 256 256 256 256 256 256 256 240 0 0
0 0 133 256 256 256 256 183 0 0 0 0 0 0 0 0 0 0 0 0 0 0 0 0 169 256 256 256 256 256 256 256 256 256 256 256 229 64 64 64 64 64 64 64 54 39 32 32 32 32 32 32 32 32 32 32 108 256 256 256 256 238 0 0
0 0 159 256 256 256 256 150 0 0 0 0 0 0 0 0 0 0 0 0 0 0 0 0 50 247 256 256 256 256 256 256 256 256 256 256 152 0 0 0 0 0 0 0 0 0 0 0 0 0 0 0 0 0 0 7 200 256 256 256 256 200 0 0
0 0 153 256 256 256 256 182 0 0 0 0 0 0 0 0 0 0 0 0 0 0 0 0 0 56 180 230 256 256 256 256 256 256 256 235 20 0 0 0 0 0 0 0 0 0 0 0 0 0 0 0 0 0 20 174 256 256 256 256 256 129 0 0
0 0 112 256 256 256 256 235 8 0 0 0 0 0 0 0 0 0 0 0 0 0 0 0 0 0 0 128 256 256 256 256 256 256 225 53 0 0 0 0 0 0 0 0 0 0 0 0 0 0 0 0 0 80 231 256 256 256 256 256 248 34 0 0
0 0 61 256 256 256 256 256 109 0 0 0 0 0 0 0 0 0 0 0 0 0 0 0 0 0 0 128 256 256 256 256 256 256 112 0 0 0 0 0 0 0 0 0 0 0 0 0 0 0 0 56 176 256 256 256 256 256 256 256 112 0 0 0
0 0 0 213 256 256 256 256 244 79 64 64 64 64 64 64 64 64 64 64 64 64 64 64 64 64 64 160 256 256 256 256 256 256 148 64 64 64 64 64 64 64 64 64 64 64 64 64 74 147 228 256 256 256 256 256 256 256 256 163 0 0 0 0
0 0 0 115 256 256 256 256 256 256 256 256 256 256 256 256 256 256 256 256 256 256 256 256 256 256 256 256 256 256 256 256 256 256 256 256 256 256 256 256 256 256 256 256 256 256 256 256 256 256 256 256 256 256 256 256 256 255 149 3 0 0 0 0
0 0 0 12 219 256 256 256 256 256 256 256 256 256 256 256 256 256 256 256 256 256 256 256 256 256 256 256 256 256 256 256 256 256 256 256 256 256 256 256 256 256 256 256 256 256 256 256 256 256 256 256 256 256 256 256 226 70 0 0 0 0 0 0
0 0 0 0 54 255 256 256 256 256 256 256 256 256 256 256 256 256 256 256 256 256 256 256 256 256 256 256 256 256 256 256 256 256 256 256 256 256 256 256 256 256 256 256 256 256 256 256 256 256 256 256 256 256 254 154 14 0 0 0 0 0 0 0
0 0 0 0 0 111 253 256 256 256 256 256 256 256 256 256 256 256 256 256 256 256 256 256 256 256 256 256 256 256 256 256 256 256 256 256 256 256 256 256 256 256 256 256 256 256 256 256 256 256 256 256 238 152 38 0 0 0 0 0 0 0 0 0
0 0 0 0 0 0 42 149 218 240 240 240 240 240 240 240 240 240 240 240 240 240 240 240 240 240 240 240 240 240 240 240 240 240 240 240 240 240 240 240 240 240 240 240 240 240 240 240 239 207 151 63 3 0 0 0 0 0 0 0 0 0 0 0
0 0 0 0 0 0 0 0 0 0 0 0 0 0 0 0 0 0 0 0 0 0 0 0 0 0 0 0 0 0 0 0 0 0 0 0 0 0 0 0 0 0 0 0 0 0 0 0 0 0 0 0 0 0 0 0 0 0 0 0 0 0 0 0
0 0 0 0 0 0 0 0 0 0 0 0 0 0 0 0 0 0 0 0 0 0 0 0 0 0 0 0 0 0 0 0 0 0 0 0 0 0 0 0 0 0 0 0 0 0 0 0 0 0 0 0 0 0 0 0 0 0 0 0 0 0 0 0